sequence_1	GGCAGGTATTGCTGGGAAGCTGTAAGATGANAATAGTTGGGTTCAGTCAGCACAATATGTTACGGTAGGATCGCGAGGTT
sequence_2	GCCGAGTTTAATTGCAATCAATTAGAAGAATAAAGAAGAATTACTGCATTTCATAACTGATTTTTTTCTCTTTTTATTTC
sequence_3	GCCGCCCTGGCCGTAGCCGCCACCTCCCTGGCCGCCGTAGCCACCGCCGCCGCCGCCGTAGCCGCCGCCACCGCCGCGCT
sequence_4	ACCAACTTCGCCCCCGGAAGCTAAATGTGTTTAGCCGTCCGTCCGTCCGTCCATCGGACGAGATATGCATGTGTACTTGT
sequence_5	ATGGATATTCAGGAAACGGGGTGTGGCGGTTTGGTGAGTTCTGGGGACCAAAAGAGAAGAGTTCCATATCGACATGGCTC
sequence_6	CCGCCAAATTGTAATACAGAATCGTCCCCAAAGATTTCGGNCAGAGCTGGCATATGCCAAACATGAATACCACCTGAAGC
sequence_7	AAGNAAGGCTGAACNNGNNAGGTTCTGTGATNCCCTTNTCTCCATCAGNGANGNNNTTGCAGAGGTAGAAAATGGCAAAG
sequence_8	TTTTTTTTTTTTTTTTTTTTCCNTNCANNNNNANNTNNTTNNNTNNTNTTTNGGNAGTNNNGGANNNNNTNCNTTNNGTN
sequence_9	GTAGCTTCAGGTGTATTCATGTTTGGCATATGCCAGCTCTGACCGAAATCTTTGGGGACGATTCTGTATTACAATTTGGT
sequence_10	AAAGCATTGCGTATGTCTGGGGGAGATCATATCCACTCCGGTACAGTAGTAGGTAAGTTAGAAGGGGAACGCGAAATGAC
sequence_11	CAGCCANGTGCATGAGANANTGAAATNACTACACGANNTAAGAGCAAAGTAAAANNNAACCAAAGCNAANNATAAATACT
sequence_12	GTGAGGATGTTATTGATTGTGAACCCATATTAGGCTATTTACACAGAGGAATGGAAAAAATCGCGGAAAACCGAACTATT
sequence_13	TATGGTCGTCCTTTATTGGGATGTACTATTAAACCAAAATTGGGATTATCCGCAAAAAATTATGGTAGAGCGTGTTATGA
sequence_14	NATTACTGCATTTCATAACTGATTTTTTTCTCTTTTTATTTCGTTTCTTTTTTATTTATACCTTCTTTNTNTTTAGTTTT
sequence_15	GCGGAGCTGGCGGCGTCGCTGTCGGTGGCGGCTGCCCGGAGGATCGTTGAGGCCGACCAATNCNTGAGGGCTGGCCTCTA
sequence_16	TTAGAACCATCATCAGCAAAATCATTAGGCACATAAGGGTCTCTCAAAGAATCAGCGCTCTCGACTGAAGAAACTAGGGG
sequence_17	GCAAATGGAGTCCTGAACTAGCCGCAGCTTGTGAAGTATGGAAGGCGATCAAATTCGAGTTCGAGCCGGTAGATACTATT
sequence_18	GTTCAGGACTCCATTTGCAAGCTGCTCGGATAATTTCATTACCTTCGCGAGCAAGATCGCGCCCTTCGTTACGAGCTNGT
sequence_19	GGCCGCGCTGGCGCACCCGTACTTCAACAGCGAAGGGCTCCTCGGCCTCTCCGTGATGCAGAACCTGAGTCTGCAGCTGT
sequence_20	GAACNTTCTTGCTTGCTCCCATGAACNTTNTGTCTTGNNNTTNATTTCACNCTCCCTAGNAGNGNAGCAGNTGNNGGNNT
sequence_21	GGAAGGCGAAAAACAAGACGCCTTGGTGAAGCAACTCTGAGATTCGGAAACAAGGACTCCTATTTATCTGTAGAGCATGT
sequence_22	TAAATACGTCTCATAACATCCACATACAGAGTCAGACAGATTCATCCAAACATGCATATCATGGNTCCGAAATATCAAAA
sequence_23	CGGGTGTTATCAAACCTTTCTCTTCANCGTCGGAAATCATACTGATACCTATCCTGTCCTTGACACTGCAGCAGGNCTCC
sequence_24	ATTTGAGTGTGAGTGTGGCAAGTTCGAGCACACAGGCAGGTTGACAAACAGTCGGGAGAAGGGCTGAGCAAACGCACGAA
sequence_25	NAGCTATACCCTTATCAAACAACCGAGACATTGACAGCCTTGTTCGGATTAGTAAACACGTGCCTTCGGCGGGAAAGTCT
sequence_26	CTCGTACACACCGAATAAATACAGACGACGAGGTGCATGAATATCGCACCCAACACGGATACATGAATCGATATCTCACA
sequence_27	GTCAGTGATGCTGCTGTGTAGTGAAGCTTCGCCGAGCCATGGGCTGCTGCGATGGAGCTTCGACGGGGGCAGTCGGTGCC
sequence_28	GCGGANGAANNCGNCCNGNCTGTCGGTGAANGCCGACNNNTANNNCGNCGTGATNGCGNCGTTCGGGGCNCNGNGCGAGN
sequence_29	GAACATGGACATACACATATTCTTAGGAACAAATAAGAAAGATAAATGGAGAAGGAAAACCCAAAGCAATGTCAGAGTTG
sequence_30	GNCGNACGGAACAGGGACGGNAACAAGTAGCNCGGAACGGTAGCANCGNCACATCNAACNNTAGNCAGAACATCTCGGAA
sequence_31	CTCAGCTACTACGTCGCCAAGTTCCAGCCGGCCGCCGCGGCATTCTCGGTCCAGTCGAGCCCCCCTGTTGTGGAAGCGGC
sequence_32	CAAGCACGGAAAGATCTATGTGAATGTTGCAAAGAAGATATTGCAGAAGGGCTCCGACTATACCAAGAAGGAAACTGAGA
sequence_33	AACCAATCGTGTTGATGTCCATGAGCAGATTATTGAGAGCATGAAGAACCTCAACGCCAGGACCTACATGCTAGCAAAGA
sequence_34	GTGCTTTTTGATGAGATTGAGAAGGCGCATCCGGATGTGTTCAACATGATGCTCCAGATCCTGGAAGACGGAAGGTTAAC
sequence_35	ACAAGAGGTGGTTCAAGGGCGCCAAGAAGTTCGTCGAGAACGCCGCAGGATCCTTCAGCGTCGCATAAATATACACGACC
sequence_36	CCAGGGCCCCGGCGTACGGCGGGGGCGCGCCCGGCGCCAACTTCATGTTCATCACTCTGGTCTTGACCACGTCGACGGGG
sequence_37	CTCTGGCAGACGTGGAGCGAGATGTCTGGCCGCATGTTGAACAGCGTCCGGCTGAACTCCTGCACGGCCGCCGGCACGTC
sequence_38	CCTGGTGNCTGTGGATCAACTTNTNCTATAGAGTGTTCAGAAGCTTATGGCCGGTCTGCACCCTCGCCTATTGCCACAAC
sequence_39	CTTGCATTCTGAAATTCGAAAACACATCATCGGACCCAAAGGTTTATTAACCTTTAGTACATTCTCTTCCTTCGAGCCAT
sequence_40	CTGCACCAGGTGCATTTCCCCAAGGATGTCCTAAAGTTCCTCCACCAAATTGTAATACAGAATCGTCCCCAAAGATTTCG
sequence_41	CGGATCCTGTATCCGTGTATACAGTATACAGAGATATATCGAAAAGGAACTTGTATCTGATATCTTTCTAGAGGCTAATA
sequence_42	CTGCATTTCATAACTGATTTTTTTCTCTTTTTATTTCGTTTCTTTTTTATTTATACCTTCTTTATCTTTAGTTTTATCTA
sequence_43	GCGCGGCGTGGCGGTGCGCGTGGCGGATGATCCAGAACGACCTCGTCTTCGCCTGGGGGCTCGACTTCAAGCTCGGGTAC
sequence_44	ATTAATTCAAAGAGCTCAGTTGGAATAAGAGGAACAATTGGATATCTCGCTCCAGAATATGGTGAAGGTGGTCAAGTTTC
sequence_45	GCGGCGCTCAACAAGATGAAGAAGGAGNCGACCACGGAGCTGGAGGCGAAGCTGGACGAGGGCCGCCGCCGCGTGGAGGC
sequence_46	CCTGCATCCCACCCGCAGACTGCAGCTGGATGCAGATTGCACGGCCGGTCATGGAGCTCTACACCGAGACGACGGACGGC
sequence_47	AAAAAAGAAAGATAAGGGACAGAAAAAAAAAAAAAATGAAAGAAACAAACGTATTCAATAAGCAAAAGGAGAGAGAGGGA
sequence_48	GCTGAGCGNCGTTCTTGCCAAGGTTGTATGTCTTTTTTCAACCTACTCAANTCCAAACCNTNGGGGCCCCTTAGAGGTTC
sequence_49	AGTAGAGTAAGTGTTGGAAAGTTAAACCATGTTAAATAGAAGAATAAAACCTTTACTAGTCGCCTTATGTAATCAATAGC
sequence_50	AGCTAATCGAGTGGCTTTAGAAGCCTGTGTACAAGCTCGTAACGAAGGGCGCGATCTTGCTCGCGAAGGTAATGAAATTA
sequence_51	ANGNAATGCAAGTGGAGCAGGAGAGAATCGAGGCTGAAAAGAAGAGGGTAAAAGAAGAGGCACAGCAACTCGCGCGAGTC
sequence_52	TGTGGTTTCTTTACCTCAGGACTCGCTTTAATTGACTTTGGTATCAGAGTTTGTCTAGGCCGCTCGAAAGAAGCAGACAT
sequence_53	GCGGTGCCCAAGGGAGCGGAGGTCAACTTCCTGGTAGCCGAGATTGGCCGCGACGAGACTGTGTGGACGGCGGCGCGGGA
sequence_54	CCTGCTCAGCATCGTGTCCGGCGGGGTCGNCTTCGCCGGCATNGCCGGGGCCGTCGTCGCCGTCTCCAACTTCGACCNCG
sequence_55	GTCTATCAATAACTGCATGCATTGCACGGTGAATGTGAAGAAGTAGGCCATTGTCGCGGCAATAATGAGCCAAAGTAGTA
sequence_56	GCTGCCAAAGGGAGTGGGGGTGCCATACGCAAAAAGGAAGCGACTCATAGAATGGCAGAGGCAAATAGAGCTCTTGCACA
sequence_57	TGGTGCAGCACAACAGCTCAATTCAGGCTAAGGTTTATCAGTTCGCTTAAATAAGGTGTCCAATACAGACGATGTACCAC
sequence_58	TTCCGTCAAACTATTTCTTCTTGTCTACCTGCAGGGTCCCAACACCAATTCCTCCAGCTTCCATTATTTCTTCATCAGGG
sequence_59	GAACCAAACATGAATCTTTCGATTCATTTGGCTCTCACGCTCCTTTTTTTTTTTCTATAGCTATTTCCATATCTTTTTTT
sequence_60	AGCGGGACTACGTAGNCNACGAGGACTNCATGAAGGCNGNCAGGNAGCTNAATGACGCCANGAAGCTGGAATCCAGCGCN
sequence_61	GTGATTTCACGAGGGAATTGTTATCCAAGGGACCAAAATCCTGGCGAACACCCCCCCGGAGCCGTCAGATCTATCATGGC
sequence_62	GCTAGCTATGCCGGTCACNGCNCAGGCGGCCGGCGCAGGGGGCGGAGGCGGGNGCAGCTCGTCGGCGATGGCCTCCTCGA
sequence_63	CGGACGTCGCCGGTGAGCTCGCACACGGACGGGCGCGCGTAGGGGAAGCCCTCGTCCACGGCGTTCTCGTCGCAGCTCAT
sequence_64	TTTGATTTTCTCATTGAATCGAATCGNATTNNATGNNNATCANGGAAAGAACATTTCGCCTAGTAATNNCNAGNACNAAG
sequence_65	AACTGGGCCACCCACCTCAGCGACCCGCTGCACACCACCATCTTCGACACCTTGGGTTCCTCTTAAGTGGTCGGTGGTCG
sequence_66	CGACAACAGCAGCTTAATCTAACATTACCCAGACTGATATTATCACAATGTTAGCCGGTGACAATGGACGGAAAGAGTAA
sequence_67	GCAATTTACACTTCTTATAGGCCACATAGGGCCTTCAGCCAGAGCAGAGCTTCTCCAGAGCCATGTTCTCGTCGCCGTTC
sequence_68	ATTTTATTGATATAAAGTCAATTCGACGGATCACGTTTCCCATATGAACACATTGATATAGAAAGCAATAGAAGACTTCC
sequence_69	TTTGTTGATACTAAGAGATGTAAAAATAAGCTAGAGTAGCCAACGTTTATATGTTGTACCAGTCAGCAAATCTGCACTGC
sequence_70	NAAACTCAAGGGTATCATGGGTTACGTTGAGGAAGATTTGGTCTCCACTGACTTTGTCGGTGACAGCAGGTCGAGCATCT
sequence_71	GCCGAGTTTAATTGCAATCAATTAGAAGAATAAAGAAGAATTACTGCATTTCATAACTGATTTTTTTCTCTTTTTATTTC
sequence_72	CTATGATAGTAAATGTTTTGAGAACGCTGCCGCCAACCTACGACAACCTCTGGAGTTCGATGCCTCCACCAAAAACGAAT
sequence_73	TTCGTNCAACTTTATTTTCTTTTCCAAGAAAAAANAATATTCGCACCNCNGTCTGCAGGTGCCTGTACCTATTGTATGTA
sequence_74	GATCCAAGTATGAGTGTAGGGTAGTAACAGCACCTGATAGTCCTACAGAGGTTAGATAGTAGGACTGTTTGATCAATCTA
sequence_75	GGCGGGGCTCGCCGGCGACGCGCTCGTGCAGGCCGGCGTGGTCGCCGGCGCCGAGGCGCTCGGGGTCCTCGTCGGCNTGT
sequence_76	AAAACTCTTATTAAGGTCTCAAAGCCCTCGCAAAATTCTCCGAAACGTTGTACTGCTAAGGAATGGTGTGACGTGCACCC
sequence_77	CCGATCTTCTCGATTGTTGCATCATCAAGGTCATCTGCAANCCTACGAGTGGGCGCTACAATGACAGATAATCGGCCCTC
sequence_78	TTTCATTGTAAAGCCAAAGCCAAACATGATAAGTTTCGCCTGGCTGCTTTACTTGGCTTTATCCTCTATCTGAATCTTTC
sequence_79	CCGTGCATATACATAGCCACCGATAGCATTCACATACGAGTACGAGCATGCTTTCTCAAGCCATGTTGGTACATGAACAT
sequence_80	GACCATGGGTGGTGGCGGCGGCGGCGGCAGCTTTGATTCAGCCAACAAGCTCTACGTCGGAAACCTATCCTGGGGTGTGG
sequence_81	GGAAGTTCTTGAGCGACGGGGACAGCCCCGGGGACGCGGCCTCCGCGACCTCGGGCAGCACCAGCGCCGCCGCCACGGCC
sequence_82	AAGAGAGCTGTATTTGCAAGAGAATTAGGGGTTCCTATTGTAATGCATGACTACTTAACTGGGGGATTCACCGCAAATAC
sequence_83	GACCGAAANCNTTGGGGACGATTCTGNATTACAATTTGGNGGAGGAACTTTAGGACANCCTTGGGGAAATGCACCNGGTG
sequence_84	NAAGAAGGGCAGCCGGAGGAGCGGCGCGCCGCCGGCGGNCAGGCTAGNTGGGCCGACAGANGAGCNGGGGACGCAAGCAG
sequence_85	GAGCAAATACACTGACCATGTGAGGAGAAGAGATGTGTTTTCATGACCAGCGAAGAAGAATAGCTTGCACTCATGTATGA
sequence_86	AAAAGTCGTTTCTCNCTCGAATGGGATCATTTTTGTCGAGAAATACCCCGGCACAAACANAAGGAAACAGGTCANAANAG
sequence_87	TTTTTTTTTTTTTTTTTTTTTNTATGGCTATNTTNTNTTTNNNNGNNTAAAANAANNNTNANGNTNNGGNGNNNNGGNTN
sequence_88	GGAAAAGGCCGGGTTCAAGGCCATCGCGCTCACCGTCGACACCCCGCGCCTCGGCCGCCGCGAGGCCGACATCAAGAACA
sequence_89	TTTTTCTGTTCTGGCTCGGNTATTCCATCTAGCCNAGCCATTCATTCCTTTNNATGAAAGAAAGATAAGGNACAGAAAAA
sequence_90	GCGATCTTCTTCTTCAAGCTCTCGATGTCGGTGGCCAACTCTTTCCTGCTTTCCTTGAAGAGGAGGTAGCGGTACACGAA
sequence_91	CCGTTTTGTCTTTTGTGCCGAAGCTATTTATAAATCACAGGCCGAAACCGGTGAAATCAAGGGGCATTACTTGAATGCGA
sequence_92	GCATATTTGTAACCCATTGTCTCCTGTGGCATTCTTGTATCTGTAGGNGTACATTANTCATTNTTAGCAANNGTACANAA
sequence_93	GCGCTCCTCACCCACCCCAACTCCTGATGGGCGATGCATGGACTAAGCCATACTCTAGGGAGTATGCTGCGTTCCCCGCC
sequence_94	TTTTTATCTAGGCAGAAGAGTCCTCTTAATATTTATCTAGTCTTATATAGGTTTCGGTATATTGAAATATAAACATAAAA
sequence_95	GGGGGTTCAGATCCGTGAGCAGCAGCTGCTGCTGAGATCTGCGATGTTCTTTCTTGATCTGGCGCATGATTTTTTCCCCG
sequence_96	GACCACTTCAAATTGTGCATTTATTGACATCCAATCAAAGGCTACTGCTTTCTTGCCTATAGATGAGGCATGCCTTCTCG
sequence_97	TCGGCGTCGAGTACGAGCTCGTGCCCGTCGACTTCGTCGCCGGCGAGCACAAGAGGCCCCAACACGTCCAGCTAAACCCG
sequence_98	CTCTGGTGTACCACTGATGATAGTGTCTATGATGCTGTCAAATCGATGACACAGCACAATGTGGGAGCTTTGGTGGTTGT
sequence_99	GCAGGTTGCTCCTGAAGACGGAAGGTGTCAACAATGTCAACCACCTTCACGGCCTGGTCATCGACACCCTCATCGTCACC
sequence_100	ANGTATTATGTGTCAATTCAAAAAAACCCACCACAGTTGATTTTTATGTACCCCTCCCTCCCCTTGACTGCTCCGATGTG
sequence_101	CCACACTTCATGGTCTTTTGCCGGGCTGGGCTTCCTGTCGTGGTACCTTGCCGGCAAGATCAGGGTGTTTGACCGGGGCG
sequence_102	TGCGTTTCTTTTTTATTTATACCTTCTTTATCTTTAGTTTTATCTAGTTAATCAATAGTATCTACCGGCTCGAACTCGAA
sequence_103	CCCGGACCGCCGCCTCCGCCGGTGGCAGCGGCTGCAGGTAGAACCGGTTCTTCAGGGGCAGGTCGAAGTCCCTTGCCTCG
sequence_104	CGAAGTAATATTCTTTGACCAGTTACTGGAGTAAAAGGGACACAAGACTGCAACTTTGGATAGTATTCAAGTCCATAGCT
sequence_105	TCAACAGGCACGCGGTCAGAGATCACTTTCCCCTCCCACTGCTTGGGAGCTCAGCACGGTTTCACGTTCTATTTCACTAC
sequence_106	NGAAGAGCCCGAGCTGCTGCAGCAGGTTTTGAAAAGGGAATCGANCGTGATTTGGAACCTGTTCTTTACATGAACCCTCT
sequence_107	CGAGCATGAAACAGNCGACTCAGAACTGGTACGGACAAGGGGAATCCGACTGTTTAATTAAAACAAAGCATTGCGATGGT
sequence_108	CTCCCAAAAGATTCTAGCTGTACAATGCCTTCTAGTTGGTCAATGACAGACCCGACAACATTCTTAATACGGGGAGAATC
sequence_109	ATTTGTTCTTTCATCCCCAAGGCTAATAATTCCTGCAGTGATTTTTGGGCTGTCAACGTTTTCTAGTCATTTTCAAAATA
sequence_110	ATAACAGATCCATTGGTTGTCTTCCCCAGCAACAGGCTCGATGTGATAGCATCGTCCTTTGTAACGATCAAGACTGGTAA
sequence_111	CGTGTATGCCGTCCTCGAAGAACATCTCGACGATGTGGTTGCCGTTGTCGGTGAGAAAGAGCTCCTCCTGGCCGTCGCCG
sequence_112	GTCTCCTCCCCCTCGGGGCCCATCTTTGCCAGTCCAAAGTCTGACAGCTTCGCCGTAAAATCCGAGTCGAGAAGGATGTT
sequence_113	GCCGGCTGCTGAGCTCGTGACGCTGAACCCGGCGAGTGAGTACGCGCCGGGGCTGGAGGATACCCTCATCTTGACCATGA
sequence_114	GAGAACGGTAGTTGTGTCGGAGGTGTTGGAGGTGAAGGAGTTTTCGTGGACGCGACATTCCTGTTTCTTGTAGTTGTCGC
sequence_115	TTTTTTTCTGTCCCTTATCTTTCTTTTTTCTGTCCCTTATCTTTCTTTCATAAAAAGGAATGAATGGCTCGGCTAGATGG
sequence_116	GGCCGCCAGATTTNTCTTTCTTCTTGTTGCTGATAGTTCGTTCTGTATTTAATATCCANGATGATATATATNTCGCTAGN
sequence_117	ATTGCAATCAATTAGAAGAATAAAGAAGAATTACTGCATTTCATAACTGATTTTTTTCTCTTTTTATTTCGTTTCTTTTT
sequence_118	GCATAATCTTATTTTTTTTGTTCTTCATGAGACATCAACTTCCTCCTCGATCGAAGATCATCGATCCACTGTCTGAACCT
sequence_119	GAAAGGGCAAGGGCTCGGCACCGGCAGTTTAAGACANGGGGAGNTATTGGTGGTCCTGATAAAGGCAGGAGTCCAAAAAG
sequence_120	GCCCGCCACAGGTTCCTGCTCTTGCCGCTCGCGGGAGGACTGGGCAGAGGACGGGTGGAGGTGGAGGCGCAGCAAGATGA
sequence_121	CCCACTGCTGCCTCCCGTAGGAGTCTGGGCCGTGTCTCAGTCCCAGTGTGGCTGATCATCCTCTCGGACCAGCTACTGAT
sequence_122	ATTTTTTTCTCTTTTTATTTCGTTTCTTTTTTATTTATACCTTCTTTATCTTTAGTTTTATCTAGTTAATCAATAGTATC
sequence_123	GAACGACGCTCAGCAGAATATATGACCCACGCTCCTTTAGGCTCTTTAAATTCCGTGGGTGGCGTAGCTACCGAGATCAA
sequence_124	AAAAGGTGTAAAGNCANCNTCCGTCGTCACTCCTCGCCGNTNGGTCGAAGTTCTNGGNNNNCTGGNCGGTGCATCCTGCC
sequence_125	TGCGAGTTGTCTATTTCAAGAATAGATTGGATCTATCCGGCTGCACTTTATAATATTTTTTAGTATTTTTCGGATAAATA
sequence_126	NCGCGCACGGCGCGCACACGCAGANGTGCCGGCACGGCAGCAGCAGCACCGCGGCCGCGCCGTCNCCGCACCCCTTGCAC
sequence_127	GTTTGTTTCTTTCATTTTTTTTTTTTTTTTTNNGNNCCTTNTNTTTNTTTTTTTTTNNCCNTNTNTTTNTTTTNNNAAAA
sequence_128	GACACGACTGGCATTTCTATCGGGAGGNGNTACGCAAGGACGGATGAGATCGGCGTTCCTTTTGCAGTAACAGTCGATTC
sequence_129	GGAAGATCAAGGCTTGATTTTGACGACCAGAAGATTGCAGGATCACACCGCAGACGGACTGATCTGNTACTCACCAAACC
sequence_130	CCACGCTCCCGACGTACAGAGGCACTCTCTGATGGACCTCTGTGGGCATGATGTCGAGTACCCTCTGGTGGCCGTCGGAG
sequence_131	TGGCCATCGAGAAGGAGTGGTCTAGCGTGGAAGGCCAGGTTCTGAAGGTGGTCAGGTTGCCCGGCGTTCGTCACGATGGC
sequence_132	ACGTTTTACACCTCAAAAGTTTCTCTTCCCTCGCGCCCAAGATTCAAGCCTCTCTAATAATGAANTTATTGAGTTACAGC
sequence_133	TTTTTGGATCACGAGTGACAACAGNGTTCAACCATGTGAACAATCTTGACCTAGTTTGCCGGGCTCACCAGCTGGTCCAG
sequence_134	NGCNGGACCACACAGTACACCGTCAACAACCAGATGGTGAACGCCACCCTCATGAACATCGCCGATGCCCCCACCAACGT
sequence_135	NATTCTCGGAGCCTCTTCACNCTGCGCTCAGATCCGCTCGCAGGAATCATGGCATTCGCTTTTCTTCTGGTGATGCGGGT
sequence_136	AAAAAAGGCGTTATGGTTGTCTGAGATAATATTATAGATACATGGAATGGAAGGAATAATGAACATGCGACCTGTCCCGT
sequence_137	GTCGACGAGGTGGCGGCACTTCNGGTGGTGGTTGACGCCCTCGATCCGGTAGCACCAGCGGAGGCGGTCGCGGATGATCT
sequence_138	TTTTTTTTTTTTTTTTTTTTTTTTTTTTTTTTTTTTNNNNNNNTNNNNNCNANNNNNNCNNNNNCNNCNNNNCANNANNN
sequence_139	CGAGCTTGCAAGACTGAGCGAGGAAGAAACAGTTGATTATGTCAAGAACAACATGTGGAATCCAGTTTATCCAACAGTAG
sequence_140	TGACAATGGCATCGCAGCCGGAACTTGATGATGCCATCGCTGCCCTTGATGGACAGAGCTTGGAGGGGCGTGCTCTGCGG
sequence_141	GAAGAAATGATTAAGAGAGCTGTATTTGCAAGAGAATTAGGGGTTCCTATTGTAATGCATGACTACTTAACTGGGGGATT
sequence_142	CAGCACCGCGCCCTCCAAGTTCACCACCATCGACCAGTCTAGCGGGCTGGGGTTCAGGCTGGTGAGGATGGGGTTCGAGG
sequence_143	NGATAGTCAAGACACGCTTCAGCTGGCAAGGAACACACACACAACACAACGCTACCCCTAGGCCTTCCTGCAGACGTCTC
sequence_144	TTTTTTAGGAGTAGTTAATTAGGTAAATCATTCATTCTTACATATTCATCACTCCATCCATAGTGGAGATAGATGAAGCA
sequence_145	TCATAACTGATTTTTTTCTCTTTTTATTTCGTTTCTTTTTTATTTNTACNTTCTTTATCTTTAGTTTTATNTANTTAATC
sequence_146	TNTTTTTAGTCNCAGAAGNNGTTNNNCNANANGNNNAAATTAACACGACAGNACNCAAATGACACNTCANCANGNCNCNT
sequence_147	TTATGAACTCCCCAAGAGAAGGGTCAAGCGTGAAGCCGTTGACACCATTTCCAGTGCTCAGGACAAGCGTGCAGGAACTC
sequence_148	AAGAGAGCATCTACGTGTAACACAGGGCCGGGTCTCTGCTTGCATGCACGTCTCTGTAATCTACGTAGCTACCTCCTGTG
sequence_149	CAGCCATGACAGAAAGTATACCCGCATTGCAGGCGGACAGCAAGAGGTATGCGGTGTTGGCGACAAGCGACCCGACAATG
sequence_150	CTTGCATATAATTGGCTCTCTGAACACGGTGCCGTTTATAATGTTCCTAATTGTGCCNTTTGGGCTCCTCCACNTTTGTT
sequence_151	GCCCAGTTCATCTGAGTCTGACAAACCTCTTCAAATTGCTTGTTGAAAGACTTGAATCTCGCCTTGATCACAGATGTGGA
sequence_152	GCCAGACGATGATGATAGTAAGAAGGTTGGGGGAGCTCAGCTCTGCTCAGCTCAGACCGTGCCGTGCTCAGCTCGCCGAT
sequence_153	CTTTAGGACATCCTTGGGGAAATGCACCTGGTGCAGCAGCTAATCNANNGNCNTNAGAAGCNNGNGNACAAGNTCNNAAC
sequence_154	GATGTAGTCCCCTCTGCAACTAAACATGGTTAAATAGCCAACTTTCCCCTGGATGTGTGCAACAAGCATACACAATGATG
sequence_155	TTTGATTACGGAAGCTTCTACCCTTGTGAAGGGGATGCATCTCACTGTTTCATTGGGGAAGGAGCTGGTGAAGGGTACAA
sequence_156	CTTTGAGCACTCTAATTTCTTCAAAGTAACGATGCCGGAAACACGACCCGGCCAATTAAGGCTAGGAGCGCGATGCCGGC
sequence_157	AAGGNAACAGAGGGGGCATTGTCAATCGATGAGATGGCAGGGGGAACCTTCACAATCTCAAACGGNGGTGTCTATGGANG
sequence_158	GAGGACCTCGAGTCGGCCGTGCTCGAGCAGAGCAACTCCGTGAACTTCTACAACATCCTCAAGGACGAGNCGTCGGAGGA
sequence_159	NNNGCNTATTCACCAGNTAATAGGCAGTANNAGATCGCGGTAACAGCGTGTATGATANCCGTGCTCCTATTTNTANTGTG
sequence_160	CTGGTTTAATTATTGTAGACAAGAGTAGTCGACATGGTTGCAACAAAAAGGAATGATAAGCGAGCAAGGGAGCACTAGTG
sequence_161	GCCGNGTTTAATTGCAATNAATTAGAAGNATAAAGAAGAATTACTGCATTTNATAACTNATTTTTTTCTNTTTNNNTTNN
sequence_162	GGGCGCGATCTTGCTCGCGAAGGTAATGAAATTATCCGAGCAGCTTGCAAATGGAGTCCTGAACTAGCCGCAGCTTGTGA
sequence_163	CCCCCTTCCGTCCCCGGCATCATGTTCTTGTCTGGTGGTCAGTCGGAGGNGGAGGCGACGCTGANCCTGAACGCGATGAA
sequence_164	GGACTGACACAGTGGCGGTGCTGATGGAGTGGGTGCTGGCCCGGCTGGTGCTGCACCCGGACGTGCAGGCGAGGGTGCAC
sequence_165	GAAGNATAAAGAAGAATTNCTGCATTTCATAACTGATTTTTTTCTCTNNTTATTTCGNTTCTTTTTTATTTATACNNNCT
sequence_166	CTCGCCGTCGCTGGTGTACTTGCCGAGCTGCGCCAGGGAGTTGGCCTTGGCACGCAGCAGCAGCGCCTCCTGCGCCGCGG
sequence_167	CAGCATTTGAAGATGTTGGTCTGGATAATGAGAAGGCAATTGAGGAGACGGGCAGACGATTCAGAGAAACGGTTCTTGCA
sequence_168	TTNGNTTAACAGAGCATCAAACTTTGGCTTNNACNCAGGNGTGACANTGTCAACATACTTTGGGATCTCANTGCTATCAT
sequence_169	GCGGCAACTAACACCAAAAATCAAAATATGTGGCTCCGAGGGTAACTTACAAATTGAAATGGGCCAATAGATTTTCCAAA
sequence_170	CCACCATATCCAGACTGCTTGCGGTCATAACGACGCTTCCCCTGAGCAGAAAGGCTGTCCTTGCCTTTCTTGTACTGGGT
sequence_171	TGCTCCAATCCCGAGAACATACGCACTAACATGATCGTCCAAGTTCTAATCTAGCTTGTCCATAGTCCGTACAATAGGTA
sequence_172	NTCCATGTTGGTGGCGCCGGTAGCGTCCGGTGATCGCCCCCAGCTGCCCGGCGGCGCGGTGGGTGGCGTGGAAGAGGAGC
sequence_173	GCAGCAGGCTGAGCCTGTAGTCCACCTCCGGCGGGAAGTACCACCTCGCCACCGGCTGCCTCCCGAGGCTAGGCGGACAG
sequence_174	GTATAAATAAAAAAGAAACGAAATAAAAAGAGAAAAAAATCAGTTATGAAATGCAGTAATTCTTCTTTATTCTTCTAATT
sequence_175	CGANGAATCATCATCCCTAGGTGCGNNAANTCTGGAGAGGTGCGNCNACGNCAGCCATCTCCTCGCAGGCGGCGCCAGCG
sequence_176	GCAATTTGGAAGGCAAGGACACTTGAATCAACATCGTGATAGGAGCCATCAACCAGCACTGCTCGTAAATCCACAACTGG
sequence_177	CCGGGTACAAGCTCGTAACGAAGGGCGCGATCTTGCTCGCGAAGGTAATGAAATTATCCGAGCAGCTTGCAAATGGAGTC
sequence_178	CCATCTAGCCGAGCCATTCATTCCTTTTTATGAAAGAAAGATAAGGGACAGAAAAAAGAAAGATAAGGGACAGAAAAAAA
sequence_179	GGAAGGCCTCGATGAGTCCAAATCAACTCAATGGTTTGCATCGCAGATGCCGTCGACGGTGAGCATACATGCTGCGGTGG
sequence_180	CTCGAATTTGATCGCCTTCCATACTTCACAAGCTGCGGCTAGTTCAGGACTCCATTTGCAAGCTGCTCGGATAATTTCAT
sequence_181	GTTCAGACCCAAAGNNTGTTGTNTTTATTGAAGGAAAATGCTCAACTTAAAAGGCGNNGCANGNNTAATTTTGTTTTGAG
sequence_182	GGGAGCCTCGTNGCGCGCGTNCNCGCNGGCAAGGCCAACGCCNCCNCGAGNNGGNCGNTNNACGCGNCGGNCNACNNCNN
sequence_183	GGGCTATCCATGATCGCCAGCAAAAACAGAGCAACAGTGATCACAACAGCCGTGGGGTCAGTGGGNTACATGGATCCACA
sequence_184	ACTGAATCCATCTCGTCCGCCCGCAGGAAATTGGGGTGTGGCTGATCGATCGATTGTCTATTTCTTGCGCAGGAGGAATG
sequence_185	AGACGAGATACTTCTGCACATGTCTCAGCTCAGAAACTATTGGCGCAAGCATTAAGAGGAGGAATAGCAAGAGTAGGACT
sequence_186	CCCGTAGGAGTNTGGGCCGTGTCTCAGTCCCAATGTGGCTGATCATCCTCTCAGACCAGCTACTGNTCGTCGCCTTGGTG
sequence_187	CCCCTTCCAGCCCTACGCCGAGGTGTTCGGCCTCCAGAGGTTCCGCGAGTGCGAGCTCATCCACGGCCGCTGGGCCATGC
sequence_188	GTTTTGNCTTTTGTGCCGAAGCTATTTATAAATCACAGGCCGAAACCGGTGAAATCAAGGGGCATTACTTGAATGCGACT
sequence_189	CGACTCNCACGCATGTCAGACTCCTTGGTNCGNGTTACAAGACGGGTCGGNTGGGGAGCCCGCAGGCCGNTGCAGNGCAG
sequence_190	CAGCAAAGTTGTTTCTTTNTTTTTATTTGCCCTCTAGTTAATAATTTCAATTTCATTAAGAAAAACTAACTAAATAAATG
sequence_191	CTGGTGCCATACCTGAGATTGGATCAATGTTCTTCTCTTGGATTTCGGGTTAAATGCAGTGTATAGCCTGACTAGAGTCC
sequence_192	TCATAACTGATTTTTTTCTCTTTTTATTTCGTTTCTTTTTTATTTATACCTTCTTTATCTTTAGTTTTATCTAGTTAATC
sequence_193	CGTTGGTGTTCTNTCCGATCTCAATGCATTTCACCGCTCCACCGGAAATTCCCTCTGCCCCTNCCGTACTCCAGCTNGGT
sequence_194	ACATAAAACCCAACTCAAGTTACGCTACGGCCTACTCCACCTTTCCCTTCCCATGGGAATCATCACTCACTTGAGAAGAC
sequence_195	GCGTGCGGTTCTGCCGTCCCATGAGCCCCTTGAGGAATGGGTACAAGTGGATAATCACCCAGAAGGCGAAGAAGAGCTTC
sequence_196	CGGGAACCCTGCGCGGCTGTAGGCCTCCATGAGGGCGTTGTAGGCGTAGACGTCGGGCTCGTGCCCGGCCTGCTGCATCT
sequence_197	CATCTTTGCCGGCAAGCAGCTTGAGGATGGTCGCACTTTGGCGGACTACAACATCCAGAAGGAGTCCACACTTCACTTGG
sequence_198	GGGACTTCAACGAGAAGTACGGCGAGCTCTGGGACTTCACTGTCAACAGAGATGACCTTATCCAACCATAGGTGCCATTC
sequence_199	CACCATGGCCGCCCAGCTCACAGCCGCTCTACCATCCTACTCCCCGGCCGCCGCCAAGGCCGCCGGCGGCTCGTCGGCGT
sequence_200	AAGAATTACTGCATTTCATAACTGATTTTTTTCTCTTTTTATTTCGTTTCTTTTTTATTTATACCTTNTTTATCTTTAGN
sequence_201	GNTCATCCGAGGAAGTTCATGATCACCAGGTGGAGCACCAGATTGCACAGGACGAAATCAGCAAAGGCCCTTTCTGGGGG
sequence_202	TCGACCTCGAGTTCGCCGACCTCATGCGGCCCAACGAGATTCACAGCCTCACGCAGCAGATTATGTACTGCTATGCAGTG
sequence_203	CTTGGATTTGGTTCGGCCAAAATTATCAGGAGAATTGTTGGAATCGCCCATGTGGAGGATTTTGACTCAATTGAGGATGC
sequence_204	CGGCGACCTGCTCCGGTGTGGCCCTGTCCTTGCACTCGGCGCCGGGGGTGACCATGCTGGGTTTGAGCAGGATGCCCTCG
sequence_205	TGNGTGTGTGTGTGTGTGTGTGTGTGTGTGTGTGTGANNNCGGNANNGCACACGTCTGAACTCCAGTCACNGTATCTCAT
sequence_206	AAATCTTTTTTTTTTATATGGCTATGTTCTATTTGTAGGAGTAAAATAAGGATTAGGCTGTGGAGAGATGGCTGAGTGGT
sequence_207	CTGAATCCCAAATTTCTGCTGTGGAGGACTCTGACAGTGATGCTGCTGGCCTTGGCTCGGATCATTTGTTCACTACATTA
sequence_208	CCGAGTTTAATTGCAATCAATTAGAAGAATAAAGAAGAATTACTGCATTTCATAACTGATTTTTTTCTCTTTTTATTTCG
sequence_209	GGCATAGCAAAGCATGCAATTTGCTGTCACCACAGGAGTCCATTTTTNTCTTATTTGTTCAACTCGTCACAGGATCACAC
sequence_210	CGGGCCCCTTGACGTTCCTCATGATGAGACGGTTCTGGTCATCCAGGAACTTGACCCTCACCTGGGTCACCTGACCCCTG
sequence_211	CCGAGGCCAGGGACGGAGACCAGCAGCGTGCGGAACGCCTGCCGGTTCGCCTCTGTGTTCTCCAGGCCGATCGAGTCGAG
sequence_212	AAAAAAACCCCGAGGAAATCGNCCGGGNGAAANGGGGGCGAAAAAGCAGAGCGAAGGAGGAGAGAAGCNTCGGAGCTCGG
sequence_213	GCTGCACCAGGTGCATTTCCCCAAGGATGTCCTAAAGTTCCTCCACCAAATTGTAATACAGAATCGTCCCCAAAGATTTC
sequence_214	GCCGGAGCCTTGGTGGCAGCAGACAGCTTCGACCTCCTCTTGGCCATGCTCTCGCTCCGGCGGTCCCTTTGCTCCTTCAG
sequence_215	GGGAAATTGTATAAGATTAAGAAAGTATAAGATTAAGAAAGCTCGTGGGTTAGAGATATAGAAAAGAAAAAGTAGAAAAG
sequence_216	GTCTGCCTCTTCACCACGCTCATACGGTTCGACCTGGTGTACAACCCGCTGTTCCGGTGCAGCCGGAGGAAGCTGGTGGA
sequence_217	NTCAAAGNATTGGTCTGGGGACTGGATGAGAAGATGGATTCAATGGANGCCAAACAGAATTTTTCATGCGCTGGTGTGAT
sequence_218	GTACAACTGATGCTTCTCAAGGTAGATACAAGACATAGACATATACACAAAAGCGATTTATTGAGCTGCACTTTGTGTCG
sequence_219	TCCGTACCCCATCATCGCCACCGTATACTTGTATTCAGGGTTGTCTCGCTTCCGGAGCAGTTTCATACCACAAGCCTTCT
sequence_220	GGTAGCTTCAGGTGGTATTCATGTTTGGCATATGCCAGCTCTGACCGAAATCTTTGGGGACGATTCTGTATTACAATTTG
sequence_221	CTACGCCTCCCGGTGACCATCTCCCTGACAGNGCAGTGCATGAAGACGACAACTCTCCCCCCCGACNACAAGCAGCTCGG
sequence_222	GCGGCGGCGCGCGCATAGGAGGCGAAGCAGCAGCGGAGCCAAGCAACCGACGCCACCATGGGTATCTCGCGTGACTCCAT
sequence_223	GTTTAATTGCAATCAATTAGAAGAATAAAGAAGAATTACTGCATTTCATAACTGATTTTTTTCTCTTTTTATTTCGTTTC
sequence_224	GGAAGAGCCCGAGCTGCTGCAGCAGGTTTTGAAAAGGGAATCGATCGTGATTTGGAACCTGTTCTTTACATGAACCCTCT
sequence_225	ANTTNCCTCGNCTATNTCNTGNGGANGGATGGNNNANANGTNNTCCGTTNAAGNANNNNTTAGTCGTNNGTNTTNCTATN
sequence_226	TAGGACATCCTTGGGGAAATGCACCTGGTGCAGCAGCTAATCGAGTGGCTTTAGAAGCCTGTGTACAAGCTCGTAACGAA
sequence_227	GCTGGATCTCTACTCGTTTCTTCTTCCAAGCACCACCTNAAGGAAGCCGGCGACAGCGGCTCCGATGACGAACCACGTCA
sequence_228	NACCCAGTTGTGGATTTACGAGCAGTGCTGGTTGATGGCTCCTATCACGATGTTGATTCAAGTGTCCTTGCCTTCCAAAT
sequence_229	CCGGTACTCCTCCAGGTCTGTACACAGAGACGGAATGCAGCATCTGGTTCATGCATCCTTCATATGGAGATCGTATTGGG
sequence_230	TGAACATATGCTGAAGAGAAGGGTAGAGAAGTACAGTGTGTATGAACTCTATGCGGTGGCTTCATCAGATTCAGCAGCGC
sequence_231	GCCGAGGCCGCCGCCCGCGCGAACGATGCCGCCATGCTCGCACTCGGCGGCCGCTCCACCAGGTGCCTCAACTTCGCCGA
sequence_232	ATGACTTTAGGTTTTGTTGATTTATTGCGCGATGATTTTATTGAAAAAGATCGTGCTCGCGGTATCTTTTTCACTCAGGA
sequence_233	GGGCATTGGATTCTCACCAATGNTTNCGTTACTCAAGCCGACATTCTCGCTTCCGCTTCGTCGACCCCCNCNNTCGCGGT
sequence_234	GAAAAAAGAAAGATAAGGGACAGAAAAAAAAAAAAAAAAAATGAAAGAAACAAACGTATTCAATAAGCAAAAGGAGAGAG
sequence_235	GCCAGTGCAGGATTTAAAATATCACGCACAAAGCTTGGTAGCATGATCAGTTCTGGAGATGTTCGTGTGAATTGGTCACT
sequence_236	AAGNAGGCCAAGGCGCCCCCGACCACCGACCGGCCGCTGTGGTTCCCTGGCGCGCAGGCGCCCGAGTACCTCGNCGGGAC
sequence_237	CTCCTTTTGCTTATTGAATACGTTTGTTTCTTTCATTTTTTTTTTTTTTTTTNTNTNCCTTATNTTTNTTTTTTNTNTNC
sequence_238	AGAGCACACTGGAAACCAAAATCTTCACATTCCCAGAATAACTCACAGGGCAATAATACCACTGAAGGTCAGGTGGACAG
sequence_239	GAGAAGCAGGGCGCACCGGAGGATGCACCACAGGCAGATGAGAACAAGGCCACCAAAGATGGCGCTGCAGTTGTGGAAGA
sequence_240	CACTGACGTTCTTACTGACGCAGNAGAANACGTGCGTCAAAAATTACGTGCANANGGANTNATGTANTGTCTAAAGNNNA
sequence_241	GCAACATCGCCACGGTCATCGGCCCGACGCCTCCGGGGACCGGAGTCAGGTGACCCGCGACCTTGCTCGCCTCCGAGAAA
sequence_242	TTCATNNCACTCGGTAAAAAGCGGGGCGAGCTCAGGAACCTGTGGATGAAAGGTCAACCTCCGAGAGTCTGCACGCACGA
sequence_243	CTTCGGAGTTTGGACTGAGAAGTGTAGTGTAGGTTTAGCTTCTATGAGCAAGAAGAAACNATTCGATCGTGTGGATCGTA
sequence_244	CTCACATACTTAGCACTGTAGAGCGGTTNAAACTATGTNTAACNNNTGTAAATGCTGGNGTATTAGGGTCANGTTTCATT
sequence_245	TTTTTTTTTTTAAAGGAAATATCATCTTTCATATCACAATATTTACTCATAAGTAGATGTTCATGCCGGAACATGATTTA
sequence_246	CTCCCTCCTCNTCGCGCGTCCTGATCCATTATCCGTCCTGATCCATTATCCAGCCCAGGGGGGAGAAGCTAGTTAGCAGG
sequence_247	CTAAAGGAGCGTGGGTCATATATTCTGCTGAGCGTCGTTCTTGCCAAGGTTGTATGTCTTTTTTCAACCTACTCAAGTCC
sequence_248	CGGATCCTTATGGAAGCATGTAGAATAAGTTGAATCTTGGACACAATNGCGACTGTTTTCCTCTGTNATGTTGTGNCTGT
sequence_249	NNGCGGCCCACGGCTTCGGCNNCGTNGAGATGAGATGNGATGATTCTTTGCNTTGCATCCNCANCTNTACNNCNCNTTAT
sequence_250	CGCCGGCGAGCTCGGGCTGGGCGCGCTCGGCGCGCTGCTGCAGGCGGCCGTCCCGGCGCTGGAGTCCTTCGCGGGGCCCG
sequence_251	TCTGAACGGTTTACACGTTCTAACTAATTAAGTTCACACGCAAAGTTCCAATCAAAAATTTCGGTGCACACCCACATGAG
sequence_252	TTGTGAAGTATGGAAGGCGATCAAATTCGAGNTCGAGCCGGTAGATACTATTGATTAACTAGATAAAACTAAAGATAAAG
sequence_253	TGCNTTTCATAACTGNTTTTTTTCTCTTNTTATNTCGTTNCTTTNNTNTTTNTACCTTCTTTATCTTTNGTTTTANNNAN
sequence_254	GCGGCAGCGGTGCCCTCTCCTGCAGGGCNGGCGGGNNNTCNACGCCGTCNNGCATCTCCGNNAAGATNNNNGNNNGNANN
sequence_255	ATCAATCAAGAAAACCTCGAGAGGATCATGGCCGGCGTGAACACCAGTGTGGTTGGCCTCAAGCCCGCCGCGGCGGTGCC
sequence_256	TTTCATAACTGATTTTTTCTCTTTTTATTTCGTTTCTTTTTTATTTATACCTTCTTTATCTTTAGTTTTATCTANTTAAT
sequence_257	GGGAGGTGCAGTGTCGTGAGAAGAATACAATNGGGGCACGGTCTTCGGGCAGCGATTTCCTCGGGAAGATAGACTCGTAC
sequence_258	GGAGTGGAGGTGATAGAGAGAAATGATGAAGACAAAGAAGTTGAATTGAAAAGGAGCCTTAGAAACAGAGGGGAAAAGAT
sequence_259	GGCAGGGCGNCACGCCGCGATGTCTACATGTNTNGCAATAGTCCCTCCANTGTTTTTCCGTTGTTTTCTTTTTTGCGTCA
sequence_260	TTTGCATCATGAAATGGTTCTCAACAATTTGAACAATTGTAAAATACACACATGTGGAGAGAGAACACAATAGTTATACA
sequence_261	ATTTCCTTTTCCGAACCATGGCAGCCAATTTCCTTAACACTATGCTTTCAAGTTTCCACTGAATATTGTACAAGTTTACT
sequence_262	NCNACGAAAAGGTGGCGGCTGTGCGGCCGGCGCCGTTCTCCGAGGACGCGGTGGTCTTCGAACTGCGCGACGGCCGGTTG
sequence_263	GAACAACATGCCTATCCGTTCGCCTGCTTGCCTTTCCTGCTTACATCCGGGAACTATGTCAGGCCAGGTCAGCTCTTGCA
sequence_264	CGATTATCGAATAAATGCCAGCTTGCTGGCTCCCCTCTTCCATTTGGAAATGAAATGCTACCAGTTATCTGGGTGAGCTT
sequence_265	ATCAAGGGGCATTACTTGAATGCGACTGCGGGTACATGTGAAGAAATGATTAAGAGAGCTGTATTTGCAAGAGAATTAGG
sequence_266	TTTAGCCCACTGTGCAGTGTTCGTAATTAATTACATATATCTACCAAAAACCAACCCTGCTAAGCTTCTATAATTAACAA
sequence_267	GCCGAGTTTAATTGCAATCAATTAGAAGAATAAAGAAGAATTACTGCATTTCATAACTGATTTTTTTCTCTTTTTATTTC
sequence_268	GGCATATGCCAGCTCTGACCGAAATCTTTGGGGACGATTCTGTATTACAATTTGGTGGAGGAACTTTAGGACATCCTTGG
sequence_269	CGCATGGTGGCCAACATCAATCTCACTCCATACACATCTTCTTTAGACCCTACCTACGTCGTGACGTCGATGCCACCATC
sequence_270	GGAAGCTCGGGACGGTGGTGGACTCGAGGTTCCCGCTGAGCAGAGCGCAGGAGGCCTGGGCTAAGAGCATGGAGGGGCAT
sequence_271	CGACGACCTATGTATAAAAAAGAGAAATTTTTTGGATTTGAAGAAAAAAAAAAAATAAAAAAGAATTCTATTAATTTTCA
sequence_272	TGTATGTCCATGTTCATGTACCAACATGGCTCGAGAAAGCATGCTCGTATGTGAATGCTATCGGTGGCTATGTATATGCA
sequence_273	CGAAAAGAAGGCTGTCCAGCTTCCATTGACGGGCCCATATCGATGTATCTCGGCGGACGGGTGCGTTGCTATTGAGCTCG
sequence_274	CTGGTGCAGCAGCTAATCGAGTGGCTTTAGAAGCCTGTGTACAAGCTCGTAACGAAGGGCGCGATCTTGCTCGCGAAGGT
sequence_275	GNACCATTGAGCAACTCGAAAAAGCTNGGANTCGATTACAGAAAGTCGAACNAGAAGCGGATGNNTATCGNATGANTGGA
sequence_276	GTACANGGGATGCATCTGTGGTTCTGTTTGGTGATGCATCCGCTCCGNCTGNCTGTNCTAGAGGGCTTTGGTCTGGCTCC
sequence_277	ATACATTCACAGCGAGGNCTTCAGGTATTTCAACCACAGGAATATCCGGTGGACTCTTCTTGATGAAGGTCATAGCTTTG
sequence_278	CCCGACTGTCTGCATCCGTGACTTCTACGTCAGCGACCTCGCAGCACCGGAGCCACCGGCTACCGCGCATCGCATCAGCT
sequence_279	AGACCCGCAGACCGCCTTCCCCCCCTCTCGTCTCCGCTTCCAGACTCCTCTTCGCCGCCGCCGGCCGCCGCCCCTCCCGC
sequence_280	GGANAAGNCGGGTCGGGATCGCGCGGTGGAGGACGTGCAGGGGGGGGACGGGCGGAGCGCGGAGGACGACCCCGCGGGCG
sequence_281	GCAGATTTTAGCTTCTATCACCTGACGAGTCTGAAACTATGTACCGGCTACCGGGGATGATTGTCTTTACTAACAGCAAT
sequence_282	AAAAAAGANAGATAAGGGACAGAAAAAAAAAAAAAAAAATGNAAGAAACAAANGTATTCAATAAGCAAAAGGAGAGAGAG
sequence_283	GCATTTCATAACTGATTTTTTTCTCTTTTTATTTCGTTTCTTTTTTATTTATACCTTCTTTATCTTTAGTTTTATCTAGT
sequence_284	CACCGCAAATACTACTTTGGCTCATTATTGCCGCGACAATGGCCTACTTCTTCACATTCACCGTGCAATGCATGCAGTTA
sequence_285	CCAACTTCATCTAATTGCTACAGAGAAACAAGGTGCTACTTTTCCAATTGTCTTCATGGCTACACAAATTTGCTTTACCA
sequence_286	CCGAAGTTGCGGCTCATTCTGATTCTGAACNGCTTCTTGGGAAGTAGCGACAGCTTGGTTTTTNNTGAGTTGTTCCATTC
sequence_287	GTCGAGGGGCTTTGGTTTCGTTACCTATGGCTCTTGTGATGAGGTCAACAATGCAATCTCGAACCTCGACGGTGTGGACC
sequence_288	AAGAGAGCTGTATTTGCAAGAGAATTAGGGGTTCCTATTGTAATGCATGACTACTTAACTGGGGGATTCACCGCAAATAC
sequence_289	GATTGGATCTATCCGGCTGCACTTTATAATATTTTTTAGTATTTTTCGGATAAATAAGAAAAGGGTGCACGATCTCGACG
sequence_290	NGTATTCATGTTTGGCATATGCCAGCTCNGACCGAAATCNTTGGNGACGNTTCTGTATTACNATTTNGTGGAGGANCTTT
sequence_291	CTNNAATGAGANGCCACANTACTGACCGNAAANACCACCATGANTANAGTTACACAACACGCAAACCATTCGGAATGACT
sequence_292	ATGGAGCACCACGCAGCCACCGTTTAATGTCGTACATCTCATTCCAGGCTTGCACAATTTCATCAACGTTGAAGCCCAAA
sequence_293	GGCGCTCATCGNCTTCGCAGAGCACCGGCGGCTCCAGGNCTGGNACAACCCGNGCTCCATGGGGANGCANNACTNCCTGG
sequence_294	GAACNGANCCANGTGCCACGTCACCAACCACAGCCAGAACTGCGANTGGNGNGNCGGGGGNGAGGGGAAGTGGGCGAGCT
sequence_295	NTAGTAGATGGTAGATAGATCATAGATATGATGCACGCGGTGCATGCATGATCAATGATCTATCTACCATCTACTACCAT
sequence_296	CGGAACACGAGAATTTTTACCCTACAGAGTAACCTAGATTGATCAAACAGTCCTACTATCTAACCTCTGTAGGACTATAG
sequence_297	AAGTACTTTCAGATGGACGTCTTGATGATGAGAAGCTTGGTCCCTTGAATGAGCTGAGGAATATATTTGGGCTTGGTAAG
sequence_298	GCTTCCCTCGCCTCTTTTTCCTCTATTTCTTTACGGATCCTCTGCTGCTCCCTAAGTCTCTGTTCCTTCAAAAGCCTCTC
sequence_299	AAGAACTGCTGTTGATCATGGCCCAGTGGACAACAGCCGTGTAGCCATGTTCCAGGATTCGCCGGTTTTGGCGGTAGAGC
sequence_300	NAACTTTAGGACNNCCTTNNGGAAANGCACCTGGTNCANCAGCTAATCGANTGNCTNTAGAAGCCTGTGTACAAGCTCNN
sequence_301	CCTCATTCCAGTCTGGAGCCTATCAGCCCCAGCACATGAAAGCATCTTGTTGATGCGAAGGACATGGTATGGATGGACCC
sequence_302	ATCAAGGAGGAGATCCCCACCATCTCCTACGCCGATCTCTACCAGCTTGCGGGAGTTGTCGCGGTGGAGGTGTCTGGTGG
sequence_303	CTAAACGGGAGGACACAAGAGGCGGCACGTCAGCCCACCCCAAGGAGCCACAGGTTGCCGCGGCCACGCCCGAGACGGAC
sequence_304	TGGAGAGACCGTTTTGTCTTTTGTGCCGAAGCTATTTATAAATCACAGGCCGAAACCGGTGAAATCAAGGGGCATTACTT
sequence_305	CGAGCGGGAGGAGGTGCGCGTGATGCCGCAGTGCGGCCACGGATTCCACGTCGACTGCGTCGACACCTGGCTGCGCTCCA
sequence_306	NTTGTTTTGAAGAAAAATTCGAATAATTGACAGAAAATCTCGACAAAGATCAAGCAGATGTTCTAGAGACGAAGCAATAT
sequence_307	CGGCGAACCTGGCGGACCTGGTCATCGCCGTCGCGGACATCGAGCCCAACCCGTTCTGCAACCACGCCGTCACGCTGGGG
sequence_308	CTCCAAGAGACGTTGAGTTTCCTTACATCAAGGAGGACCCTTTCAAGCCTACAGCGGCCATTGTGAAGTTCTATGTTCTG
sequence_309	CNGAAGCTCAACCTGAGCAGTGACTTGCGCCCATACTGCTTATGGTGTAGCTGGTAGCTGCATGTCTCTACTCTGCTGCC
sequence_310	GGGAAGAAGGGGGCGGGGNAGAAGGCGGCGGCGGCGGCGGCGTACGAGCAGATGGGCAAGACGGAGAGCATGAGGGTGGA
sequence_311	CAAGAAAGGAAGAAGAAGAAAAAAGGACATGGCATCTGCTACTCTCCTCAAGTCCTCCTTCCTCCCCAAGAAGGCCGAAT
sequence_312	TTATTACAAGCACCGTGCAGTGCAGTGCAGCCGGCTAATTATTATACATCACAAGATCCATGAGACATGTCACGCATCAN
sequence_313	CACATTTACAGGGTTATCGCTAACAAACTATTCCTGCAAGTTACATCCCATTTTCAAGTGATCTGGGAGAAAAAGAAAAC
sequence_314	TTTTAAACGACAAACAAACAACCAGATATTAAACATATAACAAAGTCTTCATATCAAAATCCAAGGCACAAACTGATGAT
sequence_315	TGCCNGGTGTTATACCGGTAGCTTCAGGTGGTATTCATGTTTGGCATATGCCAGCTCTGACCGAAATCTTTGGGGACGAT
sequence_316	GCGGGCTGTAGGCTATCTACCATATGTTGGGTGGGTTACGATTGTGATGACTGAGAAGCCGATCATTAAGTACCTTCTGA
sequence_317	AATCATGAATCCATTGATTCTTCTCTTTAATTCAAATTTATTACTTAAACCGCTTTTTTATTTGGATATGGGGGTGAGAA
sequence_318	AACTGGGGGATTCACCGCAAATACTACTTTGGCTCATTATTGCCGCGACAATGGCCTACTTCTTCACATTCACCGTGCAA
sequence_319	GAGAGTAACGACGTGGCGAGAGTTGCGGCTGCATCTGGATGAGATTTTTATGCTCCTCATCAATTGATTGATTATTGGCA
sequence_320	CNTTGCTAGTGCATGTGCTGAGCTGTATGCACCGCCTAGTGCTTNTGTTGCTTTGTATGGNCTAACCATTCAGCAGACAT
sequence_321	GAATACGTTTGTTTCTTTCATTTTTTTTTTTTTTCTGTNCNTTATNTTTCTTTTTTNTNTNCCTTNTNTTTNTTTNATNA
sequence_322	TGGAATTTGGGGATGCAAGGACTGTGGGAAGGTCAAGGCTGGTGGTGCTTACACCATGAACACTGCCAGCGCGGTCACTG
sequence_323	CTTTTTTTTCTGTTCTGGCTCGGTTATTCCATCTAGCCGAGCCATTCATTCCTTTTTATGAAAGNANGATAAGGGACNGA
sequence_324	TTTTTTTTTTTTTTTTTTTTTTTTTTTTTTTTTTTTTTTTTNTTTTTTTTTTTTTTTTTTTTTTTTTTTTTTTNTNNTTT
sequence_325	GGTTGACGATGGCCTGGCTCTGGAAGATGTCTGGGGCGCTGGCCTCGGCCGAGCCATTGCCGTTAACGCCGACCTTGGGT
sequence_326	CGGAGATCCGCAAGCGCAAGGGTCTGAAGGAACAGATGACCCCTCTATCTGATTTCGAGGACAAGCTCTAAACTTTTGCT
sequence_327	GGACATCCTTGGGGAAATGCACCTGGTGCAGCAGCTAATCGAGTGGCTTTAGAAGCCTGTGTACAAGCTCGTAATGAAGG
sequence_328	CNCNGNCNCAGGCGNGGCCGCNCAGCANNAANCANGNGNNGNNNNGNGAGCANGNGCCNCNCNACNTCNNNCNCGGCCTG
sequence_329	GTATGGAAGGCGATCAAATTCGAGTTCGAGCCGGTAGATACTATTGATTAACTAGATAAAACTAAAGATAAAGAAGGTAT
sequence_330	GCTGACTGGTGTAATTGCACAATCGGCTTATCAATGCTGAAAATAAACTCCTGCCGATGCATGGAGATTGGAGAAGGAAA
sequence_331	GGCAGTGGCCCTGAGGAGGAAAACGGGGTGCTGGATGATTGGGAAGCTGTTGCTGATGCACTTTCAGTCGATGATAACAG
sequence_332	TCCCCTATTGCTTGGAGAATTCTTGAATTTAAGCTTCTGCTGATCAGCTATAGCTTCCACAGATAGCCCGATGGCCCACA
sequence_333	AGCCGGTGTCGCAACTTTACCGGTGCCAATGGCCCACACTGGTTCGTAAGCGACGACCACATTGGTCCAGTCCTTGATCT
sequence_334	NGGAAGTACCACCTCGCCACCGGCTGCCTCCCGAGGCTAGGCGGACAGACGGGGTGGATCTTGGNGAGGGTGGACTCCGG
sequence_335	GAGAACTGGTGCGCACTATCAGTACGCACGCATCGTAGCTATAGCTATAGGCTCGGCTAAATCGCCTAGAGGTCGAAGCT
sequence_336	GCATTNCAGACGCAATCTGAATTTNGTTTGGTTTTCAGCATAGAAACCAGTTACAGCACCGGAACCAGGACGGCACACGT
sequence_337	GTGNNCGTCGCCTCCGNTGGATGTCGAGACTCCGAGCCGNCTGCNGGGNTNCGGTNAGGGAGNNGGAANCTCCATNCGGT
sequence_338	GCGGAGAGGACGCTGCCACGTCCGAACCTCCAGGGCAGCGCCGCAAACTTGGTGGCCACTGTCACATCCACCGCCCCCTT
sequence_339	AAGATCTGCAGGGGCTCCAACGTGCGCAACAAGTGCGGCGTCGACTCCATGGTCTCCACGGTGTCCGCCACTCACGCCTC
sequence_340	TGCAACCTGTTTATTCTTGACAGCAATGGGAACCCCCTACCACAGGATTCTGCTGGTATCGGAGAACTTGCGCTCGATCC
sequence_341	GTGTCAGCATCCGCTGATCTAACATTGCCACCTGGTGCTGGTCTTTGTGTAGATACTGTTCATGGACCTAGGTTCTTGGT
sequence_342	NTTTGGTGGAGGAACTTTAGGACATCCTTGGGGAAATGCACCTGGTGCAGCAGCTAATCGAGTGGCTTTAGAAGCCTGTG
sequence_343	CTTCCACATTGTCCAGTAGCGGCCGTCGTAGTACCCAGGAGACGCATTGTGCTCACGGNNGATGAACCCGACCTTGCTGA
sequence_344	GTGGCGCTGTCCGGCGGCGGGCGCTCCGTGGTGGGCCTCGACGTGTGCGACGCCGTCATCCAGAGGGCCAGGCAGCGGTC
sequence_345	AGGNGGTGAAGTGGCTTCTAGGGGCCATGTAATTCTTGTATTGTACATTAAGAAAAATCATAACTTGCTAATGTTGCCCT
sequence_346	GCCGATGAGACGAAGCGTGTACTCTGACAGTGGAGCTCCCTCGTAGTGGTCGACGAGGTCCNGGAACTCGTTGTAGACCA
sequence_347	CTGAGGCGGAGGTCGTAGCGCAGGTAGGAGGCCCTGAGGCGGAGGTCGTTCATGACGTACGGCCATTGCTTCTTGTCGAT
sequence_348	GAGAAGACCGAGGCCGCCAAGAAGATGGCCGCCGACACCGGCGACGCCGCCAAGCAGAAGTCCGCCGAGGCCGCAAAGTG
sequence_349	GGCCAAAGGAGATCAGTGAAAGAGTAATCGAAGTTGCCAAATATGCCCCTCCATATTTTGTCAAAAGCTCCTTTGCTTGA
sequence_350	TAGACCTTGTGATGAATGACTGGACACCGTTCAGGTCGAGGCGGCTGCCCGTATTCGAGGAGTTAGATGCATTCAGGGAC
sequence_351	GTAAAATTCTTAGAACTACTAAACAGGGAACAACATGAGGACCCTGGCAATTCTTTAGGGCAAATTTATCAAAAATGTCG
sequence_352	GCCTGGCATTCATCTTCGTGGTGTCTTGGGAAACAATATAAATCATCCACAAGGGAAAGGGACCCATGATTCCGCTACTG
sequence_353	CAAGACCCGAGCAAGCCACACTCTCCAGCACCAGCAGGCCGGCGGCAAGCAGCGCAAGCACAGCAGCAAATGGCCANCAT
sequence_354	GAATAATGAAAGTTGTGATTGTTTTTTATTAGCAGAGACTTGCGTCGAAACATGCGACGCGTCAGGGTCTCTGTCAGCCG
sequence_355	CCGNGTTTAATTGCAATCAATTAGAAGAATAAAGAAGAATTACTGCATTTCATAACTGATTTTTTTCTCTTNTTANTTCG
sequence_356	NACAGCAGGATGCTGTCAATGGGAAGCCAAAGTCGCCTGTAGCGAATGGTGTTAACGGGGATGCGAAGGTTCCGGCAGAG
sequence_357	GAAAAACATATACCAGCTCAAGATGACTAAATTGGTCCCAAAACATTCAGTTGCTATATAGTCAAAAACATGAGAAGTCT
sequence_358	CACACTCCCACAGGCCACAGCACTCCACGCAGGCGGCCATGGAGTTGCTCCTTCTCCCTTCCCGTGCCACCGTCTCCCGC
sequence_359	GGCGAACGGTGCCGTGATTGGTGACCNGGGGNTGGNTTGGCCTCGCNNGCTTAGGCACGCTCCCCGCGGATGCGGCGGGC
sequence_360	TTTTTTTTTTTTTTTTTTTTTNNNANNNCNTTTNTNNNTNNNTTTTNNNNTTGTTNNNTGNGNANGNNNNNNNNNNNGNN
sequence_361	GGGAACCATAGCTGTATGAGTCCTGAGCTGCCGTTCTCTTCTTGACCAAGTCATATTGCTGCTTGAGAGATTCAGTTCTC
sequence_362	CAACACTACATCAACATAGCATGCGAATACCTCACAGGAAAAAAAAATCAACAATGAAGCTTGCAGGTAATCATGTGTGA
sequence_363	GGGCACTCCATTTCAGCAGCATAGCATTTTAGCCCAAAACCCTCCCCTCCATTTCATCTACGGAACGAGGAAACTCGGCG
sequence_364	GCAATTTTGCCAAATCTTGGCAGGTACGATGGCTATAATCCAAAAAACAACTTACCAAATTTTTGGTTGGGCTGGTTGGG
sequence_365	TTTTAAGAAGTGCATAGGCTAAAACATAAGGAGCACAAGTTCCGCAAAAAGCGACGGTAATACAAACAGCCAGGCCTTGC
sequence_366	CCAGCAGCGGCCCCTCCGGCCCCAGCGCCATCGCCGGGCCCGCGTCCACCGACAGCGCCAGCGCCACCGCCACGCCCACC
sequence_367	TTTTGTTCGTCGAGCGGAAGAGGCTGCCCTTTTATTACATCATCACACACAGACCATTGCTACTACATAAGGTTTGTTTT
sequence_368	CTCGAGAGTCACATATATCTTTTNCGCAATACTTNGGAGTGCAGTAACCTTGTTTTCCAANATGTCAACCTCAGCTTCAG
sequence_369	CTGCTCACACAATGCTCCCTCTTTTGATGCCCNCTGGAACCCAGCCACAACAGAGNNCNTGATTTCATTCAGATACTGCA
sequence_370	NCCAAACGTCGTCAAAGAAAAGACAGCNANTGAAGGGACAAAGACGNCTAGAAACACNGCAGAACNCNCCATGTTNTNCT
sequence_371	CCGTACTGAACTTTGTAGTAGTTAAAATAGCGATCAAATCCCACTACCACTGCTCCAACATCTTTGTCATGTTCCATGTA
sequence_372	GTGAGTACCAAGCTTCCTCTTGGCGACCTTGAGTGCACGCTTGTCCTTTCCAACCTTAAGAAGCTCAGTGATACGCTTCT
sequence_373	TGGAGTTATCTATGTCATNACCCATGACTCTATTGGTCTGGGAGAAGATGNTCCAACCCATCAACCCATTGAGCACTTGG
sequence_374	CTTCGTTACGAGCTTGTACACAGGCTTCTAAAGCCACTCGATTAGCTGCTGCACCAGGTGCATTTCCCCAAGGATGTCCT
sequence_375	CCCCTTTCCAGTTTCCAGGNATCGATAANCTTTTCCGACANTGCGTCTGAAGATTTTNAGTACAGACATGGTCGNTCACA
sequence_376	GCCGNTCTAATAAAAATAAATAACCTTCANCATTTATTCAAAGTATATGAATATTGGGGANGANAGGATNNAGGNNNTTA
sequence_377	AGGGATTCGAACCCTCGATAGTTCCTAGAACTATACCGGTTTTCAAGACCGGAGCTATCAACCACTCAGCCATCTCTCCA
sequence_378	TTTCCACCTTAGAGTACAAACGGAACACGAGATTTTTACCCTACAGAGTAACCTAGATTGATCAAACAGTCCTACTATCT
sequence_379	TTTGTCCCGGAAATAAATGTCGTATNCATACNTGCGAAACCCCAATAANTTGCTGGATCACNTACATATATAGCCATACA
sequence_380	CTTTCACGGTTCGTATTCGTACTGGAAATCAGAATCAAACGAGCTTTTACCCTTTTGTTCCACACGAGATTTCTGTTCTC
sequence_381	GCCAAAGTAGTATTTGCGGTGAATCCCCCAGTTAAGTAGTCATGCATTACAATAGGAACCCCTAATTCTCTTGCNAATAC
sequence_382	CCAGAATGCTTTGCTTTGGCTGATTGTTAGTGTGGTGACTATTTTTGTCTATAAAGTTGAGAAAGGATTAAGATTATGGT
sequence_383	GCGGTATCTTTTTCACTCAGGACTGGGTATCCATGCCAGGTGTTATACCGGTAGCTTCAGGTGGTATTCATGTTTGGCAT
sequence_384	GGAAAAGGTGGTGATGATCTATATGAAGTGCGTCTTATCTCGNAGACCACAGAGGAAGAGTGACAACGTTTGCAATNCTA
sequence_385	CTACTATATCACGAAGAGGCCACTGCAGCTGTTGCTGGAAGAGGAACATCCACTAACCTCTCAAGCATATCCAGTTGATC
sequence_386	CGACCACTTTGGGTCTATTGTACGCGGCCTTTCCCTACATTTCTGCAGGAGGCTGTTTCCAGGACTTGAACCCGTGACCT
sequence_387	NTCAATTTGAGAGAAATTGAGCTCACCGGNAGACAGNNTACANGNGCNAACTNGTTACCTGTTCCGACCNATGAAAAGCT
sequence_388	TAGACTTTGATTTATTTAAGGGGACGACACGACACACAACGGCCATGTTACAGTGATGTACAGTACAGTGGAGAACGAGG
sequence_389	TTGTAATCTTGGGACCCANCTTCCTGACGCTNTTGCTNCTTTTCGTTNGNGGGNNCCCACNTCTTGAGTCANCTGCTGAT
sequence_390	CTGAAAATTGGCAAACATCCACACTTCTAGTCTTATATACCTATGAAAGTCTATTTAACATACACAANTCTNCTTTTGGA
sequence_391	GTGGAGGAACTTTAGGACATCCTTGGGGAAATGCACCTGGTGCAGCAGCTAATCGAGTGGCTTTAGAAGCCTGTGTACAA
sequence_392	AAATGGAGTCCTGAACTAGCCGCAGCTTGTGAAGTATGGAAGGCGATCAAATTCGAGTTCGAGCCGGTAGATACTATTGA
sequence_393	TCACATTTTACAAGGCACAAGGACTCTCAGTTGGTTCTTCCTTGGTTGAGGAAGATAAACTTGAGCTGGCAACATCTCTC
sequence_394	GTGTAAGCCGTGTCACTGTGAAGAAAAGCAAGAANATATTGTTCGTCATCTCAAAGCCANATGTCTNCAAGAGCCCNAAT
sequence_395	NGNNCCTCGACACCACCGGCTACGNCGTCGTCTGCGTCTCNCCGCGCAACCANATGNTCTTCACGCCGCTGCTCGNCTCN
sequence_396	GGAACGCGAAATGACTTTAGGTTTTGTTGATTTATTGCGCGATGATTTTATTGAAAAAGATCGTGCTCGCGGTATCTTTT
sequence_397	CTCGTAACGAAGGGCGCGATCTTGCTCGCGAAGGTAATGAAATTATCCGAGCAGCTTGCAAATGGAGTCCTGAACTAGCC
sequence_398	ATCTTCTACTGGTACATGGACAACTGTTTGGACTGATGGACTTACCAGTCTTGATCGTTACAAAGGACGATGCTATCACA
sequence_399	AAGAAGTAATTCCACAATTGATATCCAAATCACTGTTTCAGACACCACCAAGGGCACGATATGCAGCGCTAACAGCTGAA
sequence_400	ATGCTGTTGACATATCTCNTACTCTTGANCATGTNGTNATTGNAGGNGNCCAAGATGCTATGAATGNNNCTATGACANNT
sequence_401	GGGAAGATCACGGCGGCGAGGCTGACAAAGATCAGCAAGTGAGCACCGCTGTGCTGGCGTGAAAGCTGCTAGCTAGCTGC
sequence_402	NTTNGCAGAAAAAAAATCAAACAATAATAATCGACGCCCAGTACCATAGATTCAGAGTACATTGTCGTATACATGCAGCA
sequence_403	GAGTAATCAGCTGTGACACGAAAAAAAACGAATCCTTTTGTAGCTCATCATTTATTGGCAAAGATAGAAAAGGTCAATAT
sequence_404	TTACATATGAGGATAGAATACTTTAAACAATCAATGTTCGCAAAACCGGGCGGAGTTCCTTGCACCTGCTGGGGGTCAAA
sequence_405	GTAGCATTAGGGACATCAAAGATCAACTACCTTGACCCTAGAATTACGGTAGCATGGTGCAAAACCCATGAAGTCCCTAT
sequence_406	GCGGATTGGANCGCCGCTTGTTNGATATGNACGNACTTACNNTANCNNTAACNAAGCANGTCNTGNNNGCATTATTNTTT
sequence_407	TAGCGAGCAGCATCCGCTCAAAGAGTATGCTTGATGTTGTTAATCGGATGTGTGTGCACCGGCGGCAAGTTTCGGGTCAG
sequence_408	AAATTATCCGAGCAGCTTGCAAATGGAGTCCTGAACTAGCCGCAGCTTGTGAAGTATGGAAGGCGNTCNAATTCGAGTTC
sequence_409	GCGCGGCCTTGCCACCTTGTTGTTCGGATCAAAGAGCAATACCTCCTCGAACGCCCTGAGCGCTGACGCGAGGTCCTTCT
sequence_410	GAAACATTGNTGGACCAACAAAACCAAGATGCGTCTCCTATGTCAACAAAAAGTCTTAATCACTGGATAGGGNGGTGGTG
sequence_411	GATGAAGTGGTGCGAGAGCGCGGTGGAGAAGAGGGTGGTTGCCGNCGNAGANNNTGANNTNCTNGGNGNANNCNGCNNCG
sequence_412	AAATCTAAAAGCTTTCAGGTTATTTATCACTGATACATCTACTCAAACAGATCTTTCATCCTTGTCAAGTTCATAATAAA
sequence_413	CAGCTGTCAGTTCTTGAATATTTATGCCACTTATTCTCAATGGACAGTGCCTGTATAGGCGCTGCCTGCGAGCATAGTTA
sequence_414	NACGGCACCACCTTCTACTTCGACTCGGCCACCTGCCGCACGCAGCAGGTCCCCGTCGGCGTGCTCCCCCCCGGGTGGCT
sequence_415	CGGCTCGTTTAGCTCTAGCGAGGCTGGTGGATGGCGCGGCGGGCGCCGCCGCCAGCCCTGGGGCTGACGTGCTGCGCCGG
sequence_416	GTTTAATTGCAATCAATTAGAAGAATAAAGNAGAATTACTGCATTTCATAACTGATTTTTTTCTCTTTTTATTTNGTTTC
sequence_417	GTAGGAGTAAAATAAGGATTAGGCTGTGGAGAGATGGCTGAGTGGTTGATAGCTCCGGTCTTGAAAACCGGTATAGTTCT
sequence_418	NAGGCAAAGAACCTTTGCCAACATCCTACACAAGGACATCAGATTTCCCGCGAGCGTATCGGTGAGCCTCCCAGCGAGGC
sequence_419	TCATANCTGATTTTTTTCTCTTTTTATTNNGTTTCTTTTTTATTTATACCTTNTNTATCTTTAGTTTTATNTNGTTAATC
sequence_420	GAANATTAAAATTCNGCTGCCATCCATTATATCCTCNAGNAGATTGACCAACTTGTTATACTTCTGACTCTCAGATAANA
sequence_421	GCCGCATGCGCCTTCGGCCTCGCTCTCGCCACCACATCCTCCACATCCTCGAATGCCTCGAGCTCCATTACCCACACCAA
sequence_422	TGGGGAAATGCACCTGGTGCAGCAGCTAATCGAGTGGCTTTAGAAGCCTGTGTACAAGCTCGTAACGAAGGGCGCGATCT
sequence_423	CTGACACCAACCAAGGAAATCGCTAGCTGCTCACGGTGAGGATGACCGGAGTTCAGGTGATGCCGGGGGTGGGCGCGGTG
sequence_424	CTNTCCCAGAAGGAGCAGNACATACANATGNNGNTCGCCNCCNNCCCNNCCCNCGNCACNANNCNCNNCNNNNNNCNNNN
sequence_425	CGTAGATATTTCTGGGGATGACGATGTCGCCGATGTTGTTGTGCCACGGGTCCGCGAGGTGCGTGGCCAGGTTCTCCAGC
sequence_426	CTGGACACGGATGCGCGGGAGATCGAGATCGAGATCGGCCGGCTCCGCCCCAGGCTCAACAAGGGCTTCTTCGACCACAT
sequence_427	GGTCTCTCTGGCAAGCTAGGTGGGTCGGGCCAGGGAGTGGAAGCCGTTCTTCTGGAGCCAGCTCTGCGCCTGCGCGGCGA
sequence_428	TTATAACCTCACACTCAATCTTTTATCACGAAGTCNTGATTGAATCGCGAGNNGTCGGCAGATTGCGATAAACGGTCACA
sequence_429	TGGGACAACAAGCAAACTGCAGGAAAAGGACCCATGAGACTAGTCTCAACTACACACTGCAACAGGTGAAAAATGATGCA
sequence_430	TGCTAAGACAGTGTGTAGTACATGATATTGAATATTTTTCAATTCATATATAACCAATGATAAATCAAATCATACCAAAA
sequence_431	NGGGAAAGGAATGCAAATGCGGTCGCGAGCTCAAATGTCCCACACGGGAGATGCGGGTCCCTGCTGCAGNAGTACGCATC
sequence_432	CAAGCTCGTAACGAAGGGCGCGATCTTGCTCGCGAAGGTAATGAAATTATCCGAGCAGCTTGCAAATGGAGTCCTGAACT
sequence_433	GAACCGCCTACATCAAATTTCAAGCACCACTGTCTGGCCAAGTTCATCCTCGTCGGCTTTCAAGCTAAAGACTACATGGT
sequence_434	NGGCAGGCATGAGCGGTGCTGCTGTAGGAACCGCCGCATCCTTTGCTTGATCAAGATCAGTGCCCTCCTCTTCGCCTTCT
sequence_435	GCAGCTTGCAAATGGAGTCCTGAACTAGCCGCAGCTTGTGAAGTATGGAAGGCGATCAAATTCGAGTTCGAGCCGGTAGA
sequence_436	CAAAGATTAAGCCATGCATGTGCANGTATGAACCAATTTGAACTGTGAAACTNCGAATGNCTCATTAAATCAGTTATAGN
sequence_437	GCGGAAGACAGGCACGAGCTTGTGTATTAGCAATTCAATACGACGCTAGAGNTTGAAGAATTTGAGACGTGCCATTCTTC
sequence_438	GGGATCTNCGGCGNCTGNATCNNAAGCGCGACNGCTCCNCCTTNNNNANNNTNGNNGGGATCTACNGNTGGCTGNGNNGG
sequence_439	CANACACACACACACANACANACACACANACNCACNNANANNCANANNNNNAANNNCACNNANNNNNNCNNANNCNNNNN
sequence_440	GCGTGGGGTTCCTCAAGTTCAAAGCCGACATCGTCGACCAGGAGACCAAGGCCAAGATTCCAGGGATCGTCTTCGCAAGA
sequence_441	GAAATATGCATGGTCATACTTCCCTGCCGGCACAGAACGTTATGCAAGTCATGTGCTGAGAAGTGCAAAAGATGTCCAAT
sequence_442	TGGGCGAACCAACCCAACGGCGTTCTTCAGCTCGTCCTCNGCATTCAGNGTGATGTNAACTNAGNCCNAAACCTGAACTA
sequence_443	GGNCAGCAAAGTTGTTTCTTTATTNTTATTTGCCCTCTANTTAATAATNTCAATTTCATTAAGAAAAACTNACNAAATNA
sequence_444	GANGCACTCGCGGCCGCGGCAGAGGAGCCGGCCGCCGCGGTGGCCAGCGCCAGCGTGTGAGGCGCCGGCGCGCGCGGACT
sequence_445	CGCCGCCATGAGCTTCCTCTTCGGCAAGCGGAAGACCCCAGCTGAGCTGCTGCGGGAAAACAAGCGGATGCTAGATAAGT
sequence_446	TTGCGAATGGAANCGANCTGTACCGTATCTNGGANCANTGCAAAGTTNGAGAGACGGTGACCGNGGAAGTANNGCGNGGA
sequence_447	TTTATATATGGCCTGTCGTGCGTCAGCTTCATCGCCTTCAAGCCACCGGGCTGCGAGGAGTCCGGCAAGGCCTAAACAGC
sequence_448	GGGGCATTACTTGAATGCGACTGCGGGTACATGTGAAGAAATGATTAAGAGAGCTGTATTTGCAAGAGAATTAGGGGTTC
sequence_449	GAACAGTAACATCACACATAATATTATGATTCCAGTTTTCATCCTTCTCAACATTATTTACAATGGATCTATAGCCGATC
sequence_450	GCAAGGGCGCCATACGCACTGTTCAAATCATGACANAAAGAAGGCAAGGGAACAAGAAGATGACNCGAGTCTCTGGATTG
sequence_451	GAAAAAAGAAAGATAAGGGACAGAAAAAAAAAAAAAAAATGAAAGAAACAAACGTATTCAATAAGCAAAAGGAGAGAGAG
sequence_452	CGCGAAATGACTTTAGGTTTTGTTGATTTATTGCGCGATGATTTTATTGAAAAAGATCGTGCTCGCGGTATCTTTTTCAC
sequence_453	CAACTCTTTACCTTTTTTTACCATTTTTGTAAACATGAACGCATAGGCTTTGGGATAATTTTTAATCTTTGAATAACGAC
sequence_454	GTCGGGGTGCTTCATATCAATAAATCCNTGATTTATGCAACCATAGCAGTGGCCATTTTCNTTGGATTCAATCTTGCAGA
sequence_455	GTATATTTCAGNTTGAAGTTTTACAACAGAGGGAATGTAAGACAAGCAATGGTCCAATTCTGTGTCAGAGCATCGCAAGC
sequence_456	GGATATTCTGGGTGGGGCCGCTCCTCGGCGCGACGGTGGCTGCGTTGTACCACCGGTTCGTGCTGCGCGGCGAGGCCGCC
sequence_457	CGGTAGCTTCAGGTGGTATTCATGTTTGGCATATGCCAGCTCTGACCGAAATCTTTGGGGACGATTCTGTATTACAATTT
sequence_458	TCGCCAGCCAAACACACACCATATATTTATATTCAGNTTCAGACATGTTCAGTACGCGGCAGCAGCTCCAGCAAACTTCC
sequence_459	ATGAAATTGTATAAGCGAATTTTTTTTTATTTCCTTAGACTTAGACCGCGCAAGACAAGAATTTTTCGCTATTTACGATT
sequence_460	CCTGAATGTACTACCTCCTTTCCCTTTTGATCTTGTCAATGAACCAATTTTTCCTGAGGTAGTAGTGGGGGTGATGGAAC
sequence_461	CGCGGACGTACATTCGGATACATTGCATAGAGTTCATTACCGGCCGGGTCCCACTTGGGCATCGGGAAGAGCTCGTCGTC
sequence_462	CTCGCAACGAGCGCAACCCTCGTGTTTAGTTGCCACTATGAGTTTGGAACCCTGAACAGACCGCCGGTGTTAAGCCGGAG
sequence_463	CCNGNACCGCCGATGNGTNNGAAGAGTGGGGANACATGCAANNNNNACCCAAGGCGCACATGTNCTNGTGGCNNNANCNT
sequence_464	CCGGCTGCTGCGCGCTGCGTGGTCTACTAATGTTTTCACGCGGATGGGAGCACCTTCTTGACGATCTCGTCGCTGAGCGA
sequence_465	GTCGTTCTCTGATTGCATCCCGTTCAATAGAGTCATACCTAATTCAGATACTGAAGACTGGTTTCTTCCATGCTGATCCT
sequence_466	TTTTTCNACCTTAGAGTACAAACGGAACACGAGAATTTTTACCCTACAGAGTAACCTAGATTGATCAAACAGTCCTGATA
sequence_467	AAAGATTTCGGTCAGAGCTGGCATATGCCAAACATGAATACCACCTGAAGCTACCGGTATAACACCTGGCATGGATACCC
sequence_468	AGAAAATCGATGCCAGGATACCTGCTGGATTCTTAGAAGGGATGACAAAAGTTATACCAGGCCTGACTGGAACAAATATC
sequence_469	CAATTATTTCGAAAACCTGGTCCGTGCATTGGAGTCTGGATTGAATGATGTTGGAGCTCATACCGGCCAAGGTGCATGCA
sequence_470	ATAATAATAAGATAATATTAAAAACAGCAGTACGAGTCTCCAGGCAAAAAGGAAATGTTCGACATTTCACTAGGGGTGGG
sequence_471	GCTTGAGATTCGCCGCCGGGAATCAACAGGATCAGGTCCTAACACATATGTTGAGACTGAGACACTTGCTAAATTTGAGC
sequence_472	ATGAAACGTACCAGTGTAGGAGCCAGCAAGGGCAGCCCCGGGGNCCCCTGGTCTCTGAATCCTGTAACTTTCANTAATTA
sequence_473	GCAATATCTGATATAGTTCTCATCGAGCTAAGACACTAGACACATATGCTTATTCTGAAAGGCGGCGGCGGAGGCCGGTG
sequence_474	TATGCTCACAACCATGCGGGATTCTTAAGCGCGGTGACGACCGCCTTGACTTGCAGGTAGTTCTTCAGGCTGTCGATGCC
sequence_475	CTGNACTTGTTTGGTGTAAAGCTGAGTGATGCTTCAAAGAAGCTTGGAAAGAAGTTTGCTACTGGAGCTTCGGTTGTCAA
sequence_476	ATAAATTCCTGTTTATTTCATCCAATAGAGTATTATAGTACAACTTGAAAATTGGGCTCTAACCACAGCAGCCACAGTAA
sequence_477	TGACGATCTCGTCGCTGAGCGACACGATCTGCGCGTCCAGCGCCTTGATGGCCTCCTCCTTCTGCCCCTCGAGGCTCGCG
sequence_478	NGTTCATCTACGTGATGNTTGCCNCGAAGGCACATCNCTAGNCAATTTATCTGTGTCCTCTGCAGTTAGCTGCCCTGNAC
sequence_479	CATGATTGCTACTGGTTGGATCGGATTCTTTTGGATGATTTGGTTTGCTGCAAGGAAGAGCCTGGACCTTACCAAGCACT
sequence_480	TATGCATTTCCGTGTATTAGCTAAAGCATTGCGTATGTCTGGGGGAGATCATATCCACTCCGGTACAGTAGTAGGTAAGT
sequence_481	CCGCAGAGGACAGCAGGCTCGCCGTGGAGAACGGCGCGGCCGGAATCATCGTGTCCAACCACGGCGCCCGGCAGCTGGAC
sequence_482	CCAAGCTCTCCATCGTGCCCGTCAGGCGGGGCTACTGGGGGAACAAGATCGGCCTGCCCCACACCGTGCCCTGCAAGGTC
sequence_483	CTTCAATAGCTTTCTTCTTGGCTTTTTCAGCCTGTTCCAGTTCTGTTTTCCTTAGATTAACCTTCTCCTTTAGAAATTCC
sequence_484	CGAGAAGTTCGCCGACGAGAAGTTCGTCCACAAGCACACCAAGCCCGGGATCCTCTCCATGGCCAACGCGGGGCCCAACA
sequence_485	ATTTTTTAGTATTTTTCGGATAAATAAGAAAAGGGTGCACGATCTCGACGAATTACTTCTGAATAAATTCAGAAATCATA
sequence_486	NTCGGATAAATAAGAAAAGGGTGCACGATCTCGACGAATTACTTCTGAATAAATTCAGAAATCATATGGAAGAACCATAG
sequence_487	CGGATCTGCCTGCCGTCCAGGTCCACACCGTCGAGGTTCGAGATTGCATTGTTGACCTCATCAGAAGAGCCATAGGTAAC
sequence_488	GAACAATGGGAGCACCAAATTAGCGGGCGAGATGGTTGTCTCCTGGAATGCAGCCCTAAGAGCTGGCGACCTGCGGTTGC
sequence_489	CGCCGGCCGGAGANCCGACGTTGTTGTACAGTTCCTGCACGCACGGACGCACGCGCGCATAGCCAGCGTGGCAAGGCAAT
sequence_490	NCAGGACGAAGCAATGCAGATATATTTGCGAGGGCTTGTCTTGCACGTGCTTCAGTTGACCATGAGNAGTGCATTGCAAA
sequence_491	CNTANGCGGCATATATGCAAAGAACACATCTGGCATTACAGCACAACATCTAGAATGGGTACATCAAACAACACTGAAAG
sequence_492	TCACATGAAACTAGAGGCCTGCAGCACACAAACTAGGCAGAATAATAGCAGGGATTTCACTCGATAAATCATGAGTGCCC
sequence_493	ANNTTGCTTTGGANTTACACTACAAATATTCTNNNTATNCACTAGNAAATTACTGGAAATCNACNATNGANNACAGTNTN
sequence_494	CGACAATATAATATCATTCACATGATAAACATTAGACAAATACATACAACCTATGTGTACAACGGATGCCTAATACCCAG
sequence_495	CAACTCTGAGCTTGTCAAGGCCCCGGCTACCGCAGTCGCCATGCCGGTTGCAGCGGGAAAGGCGCCTGTTCAAGCTGAAG
sequence_496	TTTTTTTTTTTTTTTTTTTTTTTTTTTTTTTTTTTTTTTTTTTTTTTTTTNNTTTTNNNNNTNNNTNNNNNNTNNNNNNN
sequence_497	CCGTGGTNGCTCTACTGGCTACGACANCGCCGTGGCGCTACCCGCCGGNGGCAGNGGNGACGAGGAGGAGNNGGCCAAGG
sequence_498	GCCAGGGGGGCCTTCCGTGAAGGATTGAGGAAAGCTGGCCCACGACTCCTGGAACCTATAATGAGGGTTGAAGTGATTAC
sequence_499	AGGCCAACAAGAAGGCCATGAACATCCAGTGCAAGATATGCATGCAGACTTTCATCTGCACCACCTCTGAAGCAAAGTGC
sequence_500	CTCGACCGAGCCATAAGCTTCTACGAGAAGGCTTGTGGTATGAAACTGCTCCGGAAGCGAGACAACCCTGAATACAAGTA
sequence_501	GTAAGAGGAAGGAATGGCGGACGTCGAGTACCGCTGCTTCGTGGGCGGCCTCGCCTGGGCCACCGACGACCAGTCCCTCC
sequence_502	CGGGGCGAACGGAGGAGAAAATTCCAGATTCAGCATTAAGTCTACTACAGGGAACAAAACGATCCAAAAGCGCTACTGTT
sequence_503	CCGCAAGGGAGATGATGGAGAAGTACCACATCGGGGAGATTGATGCTTCAACCATCCCAGCAAAGCGTACATTTGTACCT
sequence_504	GCCGAGAGCTGGAGGCAGTCCGGCGCGCCGGTGCTCCCTGATCTCGAAGCCGCGCAGGCATGGCTCACCAAGAACCCGAC
sequence_505	AGAGAAGAGTGGAAATGCTAGCCAATATAGCTAATTTCACTTTTAAATGGGAATGGGGAGGCAGTGGGGGTACAGAGGAT
sequence_506	NCAGATCATGCAAATAAGTATATCAGGTATCAAACAAGTTGTCCGAGAAGGCCAAAACAGAAATTCAGAAACTAGCACTT
sequence_507	TGNCAAAAATCTGCATACCACCACGAAGCCTGNGCACAAGGTGGAGGGNGGACTCCTTTTGGATGTTNTAGTCCGNNAGG
sequence_508	GCCAGGTCAAATAGCCATGAAGTAACAAGCAAACTCTTCCAAAAAAAGACCAACTGTTTCGACACTGAATTTCAAGTCCT
sequence_509	TAGCCGTCGACGTTGGCGCCGTACTTGTCCACAAACTGGTACACGCCCTTCTTGCCGACCTTCCTGCCGTTGGCGTCGAT
sequence_510	GCTGACAAGACCATCGCTGGTGGCCATGAGGCACTTTATGGAGCAATTGGTGACGGCAACAACAGAGCCCTCCTGTTGCG
sequence_511	GGCGCGATCTTGCTCGCGNAGGTAATGAAATTATCCGAGCAGCTTGCAAATGGAGTCCTGAACTAGCCGCAGCTTGTGAA
sequence_512	TTTTTTTTTTTTTTTTTTTTTTTTTNNTTTNNNNNTTNTTTNNNNTTNTTTTTTNNTNNNTNNTTTNNGNAATTTTATNN
sequence_513	CTTTAGGTACCTGCTCAACCTAGGTGCAGGGGAGTAGAAAGGCTGATCCAAATTTATTGCTGTAGCTACCCATTCAATGT
sequence_514	TTTTTTCCATCTTAGAGTACAAACGGAACACGAGAATTTTTACCCTACAGAGTAACCTAGATTGATCAAACGGATCGGAA
sequence_515	GCTGAATAAACTTTTAGGGGATGTTTTGCCTAACGGGCAATTGCGACATTCCCGGATATTTCTCGCTCAACAGTGCTCAT
sequence_516	TGAACACGAAGGGCCGGTTGACCCAGCCCTGCCAGGTCTTGAACGCCTGCCACTACTTTTCAGGAGGNTACCACTNAATC
sequence_517	GGAATGCATTATTGAATTTTCCCTTCGTGAGCAGTCGCCGCTCTCGTGCACCACTCGATACGTGAGGNATNGCATNGATC
sequence_518	GGAAGGCTTTGCTTGGAGTTTAAAGTAGTGGATTGCAGAGATATTGTGCAGAGCCAGAAAAGCTGGAGGCAGGTGCATCA
sequence_519	AGCAAATACACCTAACAAATTGGAATTTCTCTCAAAAACATATCTACCTAATAACATTAAGAAATGGAGGGAGTATATAG
sequence_520	GCATATGCCAGCTCTGACCGAAATCTTTGGGGACGATTCTGTATTACAATTTGGTGGAGGAACTTTAGGACATCCTTGGG
sequence_521	GCCGAGGCTAGTGAACCTCCAAGCACAGAGGTGGCTGCTATGAAGGAACCAGAGTTGCTGAGCACTGAACCAGCACCTGA
sequence_522	CTCACAATAGAAACTTGTATTAGCAAAAGCCAGTAACAAACACCACGCATAAACCATGCAGGTTATCATGTCAGTCTGCA
sequence_523	ATNTACATCGATATACCATATGGTAATGCTATTATTATCATAAGTTTGGAGTTAGTAACCAAACCATCTCACCGGAATGA
sequence_524	CTTTGGTACCATGATCTCCAGTCCAGTACCGGTCTCGTCGTAATACGCTTCGATCTTGGCGTTCTCTGGGATCCTTGTGG
sequence_525	AGAAAGACCAAAAAATGGTGTGGTTTGTTGTTGTAGAATCATTGTACATTTTGTTTGTTGAATTGTTGTTGATTGTGTAG
sequence_526	GGAGNTCCATTCCNATCTCGCNCCAATANGGATGTCANGTTTGTTNGTTCAATNTCGATACTNCTCACACGGTGNNGNTN
sequence_527	GTTGAAACTATAGTCCATACAATAGGGGGCAAAAGGAAAACGAAAAAAATCTGGTGGTGTACAGCGTTCCATCCTTCTAC
sequence_528	CTTTGGAGCATCTCTTCAATGCTTCGTACGCTGGTCGCGAGGATCAGATAGAGGGAGTAAGTGAATGCATCATCATGGGC
sequence_529	GTCCAATACTCCCATCAGAAATCAGAACGATCATGTTTCTTCTGCCCTTGATAATTTACACGTACGGCACATTCGTACTC
sequence_530	GTGCTTCTTTACAAGGAAAAGCTCTCCTAAAAGTTCCCAGGCTTATTTTTGCGATACAGGCTACAACACTTTTACAGACT
sequence_531	CGTAACGAAGGGCGCGATCTTGCTCGCGAAGGTAATGAAATTATCCGAGCAGCTTGCAAATGGAGTCCTGAACTAGCCGC
sequence_532	GTCGTCTGCAGCGGTGGCAAGAAGATCAAGGTCGACAAGCCCCTCGGACTCGGAGGCGGCTTGACAGTCGACATCGACGC
sequence_533	TTGTGAAGTATGGAAGGCGATCAAATTCGAGTTCGAGCCGGTAGATACTATTGATTAACTAGATAAAACTAAAGATAAAG
sequence_534	CGCCGGGTGATCCGCGAGGCACGGGATGAGGAGGAGGACGAGGCCTTCCTCCGCACCCTCAACTTCGGGGCTGACCCAGA
sequence_535	GTGCAAGGTGTTCGACGAGTGAACCGAGAGCTCGGAGGTTGCCGCTGGCTTGACCGGTCGAGGCTGATCAGAAAACGCAA
sequence_536	GCCGCGTGCAACCGGATGAACCCCTCGTCACCACCATCTCCGACGGCGTCAGGGTGCACTTCCCTGGCAAGACGCCGGTA
sequence_537	CAAGCACCTACAGTCCCCCGGTGGTCTCCTTGGCCGCACTTGGCCATGAGCTCGTCCACCATGGATTTTGCATGATCCAT
sequence_538	TTTTCTTCAATCTTCATAGGTCCATTAGCTTTTCTATAACAATAGTACAACACATATGAATTCGAACTTAGGACATGGTC
sequence_539	GCAGGGCTATCAAGGACCTGATGGAGAGGGGCCTCATCAGGATGGTGTCGATCCACTCCAGCCAGCAGATCTTCACCAGG
sequence_540	GATTTTTGCTACCAGCACCTAAGCTCCATGGAGGGTGATAAGAACTCGTCCGGGGACCTGATGTCCAGCAGCAAGCTGGT
sequence_541	AAATGAGAAAANTCGACCTATNCTNGCGNANCTNGAGAAGCNCNTACNTTNCNACCNNNCGCCATCAACTAACGATNNNN
sequence_542	CTGATGAACGNACTTCACCACTCNTGTCTTCTGTCTNGATCCAGACAAGTCNNAGGNNGCANCCTGGCTCCCATGGTGNG
sequence_543	CAGAGAGAGATGCCCATTCGGTGGCACGATAGCGAGCTTGCTGAGATACTGNAGAGGGGAACAAANGAATTGACCTNGTT
sequence_544	GGAGGATGGGATCCCACATATACAAAGAGAAGTTTTTTCCCATATTGGAGATCAGTGTTGCAAGCTCGGTTTCCTTTGAA
sequence_545	GCCGGCTCGAACTCGAATTTGATCGCCTTCCATANTTCACAAGCTGCGGCTAGTTCAGGACTCCATTTGCAAGCTGCTCG
sequence_546	GGGNGACTCGGTGGGAGACGACGGACACCNCGTGCGGGGAATANAAGATNAGTGAAGAAAGCAGGGGCNTTTCTGAAATT
sequence_547	TTTTTATCTGTAAAATAGTACACCAAGGAGTTGTACAACATTCTCGTTTGGCGAAACAGCTGACAAGAAAGTTCATCACA
sequence_548	CAAAAAACACAATCCTTAAGAAATATGATGGCAGGTTCAAGGACATTTTCCAGGAGATCTATGAAGCTGGCTGGAAATCC
sequence_549	GCGCAGTCTGCCTGAGCGGCGTGGCGGAGGGCGACGAGGTGCGGGAGCTGCGGTGCCGGCACGTGTTCCACCGGGCCTGC
sequence_550	TTTTTGCANAATAAAGTAACTTGAAATTACACACCTGCATAATTACATTTAGCAAAGGTTGACCTANACAAAAAGAAAGC
sequence_551	TGTCTGGGGGAGATCATATCCACTCCGGTACAGTAGTAGGTAAGTTAGAAGGGGAACGCGAAATGACTTTAGGTTTTGTT
sequence_552	CTGCTATGGTGAACGCAAGGATTCAGAAGACTGTTAGAGCAACACAAGCAAAGGTGGGCTACATTGGTCCTCCAGCAGAC
sequence_553	GACCATCTCCCAGCTAGAAAGGAGTATGTCGACAAGATTATCAACAGAGGTGGGAACCAAACTGTTGAAGCTCGTTGATG
sequence_554	CGGCCGTCCGGGCGTCCTCCGCGTCCGTGCAGGAGAAGCTCACGGCCGGGCTGACCGCGGCGGCCGTGGCGGCGGCGCTG
sequence_555	GAACTTTAGGACATCCTTGGGGAAATGCACCTGGTGCAGCAGCTAATCGAGTGGCTTTAGAAGCCTGTGTACAAGCTCGT
sequence_556	CAGAACCCTAATCTGAGATCGCGAACTATCCTCTCCCGATGTCAGACGTCACTGCCGAGTCCACGCCGCGCCAGCGCCTG
sequence_557	GTTTTCCTTCTCCATTTGTCTTTCTTACTTGTTCCTAAGAATATGTGTATGTCCNTGTTCATGTACCAACATGGCTTGAG
sequence_558	GTGAGTTTACGTTTTCATCATCTTGGTAAAATCAAGTCCACCACGTAGACACTCATAACACGCTCTACCATAATTTTTTG
sequence_559	CCTCTTAATATTTATCTAGTCTTATATAGGTTTCGGTATATTGAAATATAAACATAAAAAAGAAGATAGAGGATAGGCTC
sequence_560	TCGAATTCTATCTCGCCCTTCCTATTTTTAAAATAAAAATAGAAAAATAGGAGAAAAAAAATATGACAGAAAAAAAAAAT
sequence_561	TTACATGAACCCTCTTAACTAAGATTTTCTTATTTATACCTGTTCTACTTTTTTTCTGTTCTGGCTCGGTTATTCCATCT
sequence_562	CGGCGGGCTTGTGGAGAAAATCGTACACTGATTATTCCAGAGGACAAGCGTTCTCATGCTAGTACATGTGTAAAGTTAAG
sequence_563	TTTTTTTTTTTTTTTTTTTTTTTTTTTTTTTTTTTTTTTTTTNTTNTNNGNTNNNNNNNANNTNANNNNNNANNNNNANA
sequence_564	GGATCTCCTCCTACATGATCCGGGTGGCCAACAAGGACATGACCTACGCCACGCAGCTCAGGAACTACGAGAAGCAAGTC
sequence_565	CTAATACNCNGTAGCATCANTTNTCTACANANTGNTNTNNGTTGCNCNNTNCTNCNNANAGNGNCANTGTGNNNANTNCA
sequence_566	TTTTTTTTTTTTTTTTTTTTTTNTNTTNNNNNNCNNNNNTNTTNTTNTNCTGNTNNCNANNAAAANNNNANATANAGNTN
sequence_567	CGAGTTTAATTGCAATCAATTAGAAGAATAAAGAAGAATTACTGCATTTCATAACTGATTTTTTTCTCTTTTTATTTCGT
sequence_568	CAATCATTCCGGATAACGCTTGCATCCTCTGTCTTACCGCGGCTGCTGNCACAGAGTTAGCCGATGCTTATTCCTCAGAT
sequence_569	GGAGTCCTGAACTAGCCGCAGCTTGTGAAGTATGGAAGGCGATCAAATTCGAGTTCGAGCCGGTAGATACTATTGATTAA
sequence_570	TTTTTTTTAGAACGGAAACCGACAAACTCAATCATAGACCACGAATATTGTTACTGTTTTACNCTCACCGCAACTGGNNG
sequence_571	AACAAAATAACATTTGCTCAATACAAGGCTTATTCTTTATATTAATAAACCATGCAGCCAGATCCAGGCATTTCCATACA
sequence_572	CAAGGATCATGGCCGGGATAGAGACCAGGATAGAGACAGGAAACGTGAGCGCTCTCATGGCAGGGGCAGAGACCGTGACA
sequence_573	GGCACACCATACACGCAGCAGTCCTACAAGGTGAGCGATTCCTTCCCGTTTAAATGGATAAACAAGAAGTGGAAGGAAGG
sequence_574	TCAGGAAACAGGTGCAGCAGATTGTCGTCACAGTCCCAACCTGACAATTTTCAACATTACAATAAAATTTTGGAGGCCAA
sequence_575	GAAATTCCTTGTCGGGTAAGTTCCGACCCGCACGAAAGGCGTAACGATCTGGGCACTGTCTCGGAGAGAGGCTCGGTGAA
sequence_576	GCAGAAGCTTCGTGAAAGTAACGTGGTTCATCGGGATCTTAAACCACAGAACATTCTTCTTGTTTCAAATAATGGAACGT
sequence_577	AATACATGTTCTGCAGTTACAACTTACTACAAAGCCAATATGTACAAATTCATCATGGTTTCATGATACATGCACACGCA
sequence_578	CTTTAGGACATCCTTGGGGAAATGCACCTGGTGCAGCAGCTAATCGAGTGGCTTTAGAAGCCTGTGTACAAGCTCGTAAC
sequence_579	TCTTGCACATTTTCGTTAATCCATGAACAGAATCTATNTANGNAGACACATGGATCCGTACATCNCGATCGGNNANGAAT
sequence_580	CGATTATGAGGTGACATGATCTCTGATATTTGATTCAGTGGTGTCTCAGGAAAACCCTTAGCTTCACTAAGAGCTGAACT
sequence_581	GGCAAAGCAGGTGCCGAGCACGTATTGGGGGGAGGCCGTGCTCACGGCCGTCTTCATCCTCAACCGCTCCTTCACAAGGA
sequence_582	ATCAATAACTGCATGCATTGCACGGTGAATGTGAAGAAGTAGGCCATTGTCGCGGCAATAATGAGCCAAAGTAGTATTTG
sequence_583	TAAACTTACAAAATAATCTACTTTCATTAAAAGATTTATTAGATAATCGAAAACAGAGGATCTTGAGTACTATTNGAAAT
sequence_584	GCCGAGTTTAATTGCAATCAATTAGAAGAATAAAGAAGAATTACTGCATTTCATAACTGATTTTTTTCTCTTTTTATTTC
sequence_585	TTTTGATACAACATTACAAACCCACACAAGACGTTACAAAATGTTTGTGTTCCAGATACAGACAGTATACGCACAGGCCA
sequence_586	CGAAGATGGTGGCGCCGAAGGCCCAGGCGNCGCCGAGGTACCCGACGCCGGTGCCCGGCTGGGCGGCGGACTGGCTCTTG
sequence_587	CCGGCGAGCAAGGGTACCCGGGCGGCAAGTTCTTCGACCCGCTCGGCCTCGGTGGCGAGACCAAGGACGGCGTCTACATC
sequence_588	CGGGTACCATAGCTGAAACATCACCAGGAACTGTGTTCTTGTTTGCTGCAATATGCACATTTTCTAAAACCTTCTCCACT
sequence_589	GCAAAAGATCTGCAAAATTACATCACATTACAATGTTACAACAATACTGCGTGCAGAAGCCTCTTCCAGAACTCGATGAA
sequence_590	CTTATAGAAAATAAATACNCCACANNCTCATTNCTCGNNTAATAAAAATNAAACGCCAGTTCCTCCCCTACAGGAAAAAG
sequence_591	CAAAGAGCTCGTGAAGGCATTCAGGGAGGCTGTTGAGGACGGGAGGAAGTTCCACGGGACGAACAAGCCAACAACAAACG
sequence_592	GCGATACATCAAGAACCTCTCTGCCAAGCTTGAAGGCGATGACCTAGATGTTTTCAAGAAGAATGTTGAGTCTGCCACAA
sequence_593	TNTATCTAGTTAATCAATAGTATCTACCGNCTCGAACTCGNATTTNATCGCCTTNNATACTTCNCAANCTGCGGCTAGTT
sequence_594	CTTGGAGGAGTGCCGGCCATGGCCGTTGAGGCATATTAGGCTAGGCTATATCTCTATTTATCACAACGTACCTAGGTACT
sequence_595	CCGTCTGGTCGCCTCCGGCTGCGTCAGGCCATTCAGATCCCTACGCTGCGGATGAAACTGACATTTCCAGTAGGAGTTAT
sequence_596	CTTTGGGAAAGCTGAATCCTAATCGAGCAGCAATTCACAATCCTCATGGAACGAAGTGGCGGCAGGAATGACAGTACGGA
sequence_597	CGCGCATATAGACTAGTAGGAGTAGTTAATTAATTAATTAATTAATCCAGCTCGCCATCAGGTGAGCCGGTTTATTCCCT
sequence_598	ATTGATANACAGAAAANTCATGGTATGCNTTNNNGNGTANTAGCTANAGCATTGCGTANGTCTGGGGGNGATCATATNCA
sequence_599	GTTTAGAGGCCGCAATGCAAGAATTTTTTCCCAACTCAAAGGAAGAGTACCATGACGAAACTGTTCTGCTGTTTCTTTAT
sequence_600	GGCAATTCAGGCCACCACAAGTCCTGAATTATGCTCCAGAAGAAGAACAGGNAATGCCATGATAACATAAGGAGTAACGG
sequence_601	CTTCGTTCCAGTTGCAGCACCCGTAGGTCGTTGCTCCGCAGAACTACGCCCGCCACCTGTTCGGCCAAATGTCTCACCGG
sequence_602	GTTTTTCCTGACCAGCAGCACCCCAGCCACAGCAACAAACAGCAGGGTTTTGCAGAAGAAGTTGCCCATTTGGTCGACGA
sequence_603	GCCGAACTTTGTTGATGAACATGCCATATAAATCCTCCGCCGGTCCATAGTGGTCGGCCATGTCGAAGGTGGAGAGGCCG
sequence_604	GGGGCANCTGTTGCTGTGGAAGGTGCCGTCCCTGCNCCTGTNGTGGCTGCTNCTGGCTGGGACGCNGCGGTGCAACCCCC
sequence_605	CACCAATGCATCAATGCCATCCACCATTAATAATCCAAATAAGTAATTCGACGAAAATTAAGGGCAGCACTTCAGCTGCA
sequence_606	TGGCCGGGCGCCGGGACCGGCGGCAGCGGCGACCCGCTGGAGGACTACTGCAAGACCGACCCCAACGCCGTGGAGTGCAA
sequence_607	CCTTATAGAAAATAAATACACCACAGACTCATTACTCGAGTAATAAAAATTAAACGCCAGTTCCTCCCCTACAGGAAAAA
sequence_608	GGACAGGAAAAAGGTAAGCGTCTACCCATATGAGAAACAGCCTGAGAACCCAAACAGTTACAGAGCAAGGAAGAGAGAGN
sequence_609	GCTCGAACTCGAATTTGATCGCCTTCCATACTTCACAAGCTGCGGCTAGTTCAGGACTCCATTTGCAAGCTGCTCGGATA
sequence_610	GGCAGGATGGCAATGAGGTTTTCTTCCGCNNCANGAGATCCACACAGCTNAAGANGCTGATGAATGCCTACTGTNNCNGT
sequence_611	GCGAGATGGGCCGAGGGCATCAGGATTGAGCCCGGGCTTGCACAGACGGTGCGCGAGCTCCTCGCCAAGCCCTGACGTGC
sequence_612	CATGAATCAGGAATGATTATCCTTGAAGAAATATAATAACAACCATAACAAAACCATGACTTTAAAACACCACCACTTAT
sequence_613	ATTTGTAGGAGTAAAATAAGGATTAGGCTGTGGAGAGATGGCTGAGTGGTTGATAGCTCCGGTCTTGAAAACCGGTATAG
sequence_614	AATTACAATACATAAGTCTAATACACAAAAATTGGGCAACACCAATGTTCCAGCTGTCCTCTGGAATATCTACGTTCGAA
sequence_615	CCCGAGNCTACATGTACAAGGTGCTCTAGTCCCCCCTGGTGTTGCGNTGCTCTATGCATCTGCTGGACTTGCCATATGNT
sequence_616	GAAGGGCGCGATCNNNNTNNCGAAGGTAATNAAANTATCCNAGCANCNTGCAANTNNAGTCNTGAACTAGCCGCANCNNN
sequence_617	CGCAAAGGCCGAGGAGGACAAGCTAGGAGGAGCGAGCAGCCATGGCTTCGTCGGTGGCCGCCGCGGCGAGCGCGTTCCTC
sequence_618	TCAGGACTCCATTTGCAAGCTGCTGGGATAATTTCATTACCTTCGCGAGCAAGATCGCGCCCTTCGTTACGAGCTTGTAC
sequence_619	GGTTGACATGGATGGTGCTCGCCAGTCATCAGATCTGTGCTTACTCTCCTTCAGTTCCACCCACTAGGCTAGTTAACAGG
sequence_620	CGCCGAGGGGTCCCACCNGCTGCTGCACGCCGCGGGGAGGCAGNACTGCATCAGGNNGTTCNGGGNGGNTTCCTCGTCGA
sequence_621	NGNACGGGNAGCTGGATGNCTGNGAGNAGCGCTATAGAGNCNTGGTTGGAAGTGGCANCNNGGTNGNNCANNANGTTTNG
sequence_622	NATAGCTCCGGTCTTGAAAACCGGTATAGTTCTAGGAACTATCGAGGGTTCGAATCCCTCTCTCTCCTTTTGCTTATTGA
sequence_623	CTTGTTTTCTGGGATTTGCTTGAACTAATCTGCCTCCTTAGGCGCAACATCTCACCCTTCGCNAACGCCAGTTCCTCTTC
sequence_624	CTATGTTCTATTTGTAGGAGTAAAATAAGGATTAGGCTGTGGAGAGATGGCTGAGTGGTTGATAGCTCCGGTCTTGAAAA
sequence_625	GAAGAACTGAGTCATTGTTATCGGACACGAAGAACGACATGTTTCGAAATGCATCCATGCTATTTTCCATCATCCGACTC
sequence_626	TGAATGCGACTGCGGGTACATGTGAAGAAATGATTAAGAGAGCTGTATTTGCAAGAGAATTAGGGGTTCCTATTGTAATG
sequence_627	CCCTACTACTGTACTGAAAATCACCCTTCTAGTATTAACTAACAGAGTTCCTTCCGAAAGAAAACAAACATTTTATCAAT
sequence_628	TAGCTTCAGGCCTGCACTGATTGATGCAGCCAAGGCAATGCTCGAAGGCTGAGGATGTTTTGCTGCCCTAAGGTAAGAGA
sequence_629	CTTTTTTGTGGGCCATTTATGGCATGCAGGAAGAGCCCGAGCTGCTGCAGCAGGTTTTGAAAAGGGAATCGATCGTGATT
sequence_630	TTTTAACTCACAACGAATTGATACAATAAATACGCGAAGCAGCTGGCGGCGTGTGCCAGCGCCCGGGCGGCCGGTGTTGG
sequence_631	CCAATTTTGGTTTAATAGTACATCCCAATAAAGGACGACCATACTTGTTCAACTTATCTCTTTCAACTTGGATACCATGA
sequence_632	AGAGAATTAAAAATTGTAACTTGAAACAAGAACTACAAATTTAAAGCAATAATAAAGAGCCGCCCGGGTTAATAAAACTG
sequence_633	CGGCACCATCGGCCACGTCGACCACGGCAAGACCACCCTCACGGCCGCGCTCNCCATGGTNCTCGCCTCCGTCGNGGGCA
sequence_634	CTGAGTGAAAAAGATACCGCGAGCACGATCTTTTTCAATAAAATCATCGCGCAATAAATCAACAAAACCTAAAGTCATTT
sequence_635	TGCGAGTAGCTTAAGTGGCGTATGGAAGGGTGTCGGAGCTGTGTTCTCACCAATCACAGCAGAGATGGAACCTGTTGGAC
sequence_636	ACAGAATCGTCCCCAAAGATTTCGGTCAGAGCTGGCATATGCCAAACATGAATACCACCTGAAGCTACCGGTATAACACC
sequence_637	GCGAGTCGACGGGTTCTGAAACCTGGGATGCGCAAGGAAGCTGACGAGCGGGAGGCCCTCACGGGCCGCACCGCTGGCCG
sequence_638	GCCAATGTTGGGCATCAAAGTACATCCCTTGAACTTTCTCCTCACACGGGAATCAATACCCTTTGGCCTGCGCCAGCTGG
sequence_639	GAGGAATCTTCCGACTCGCAGAAGTAGGCACTTGCAAAGTGTCCCCGTCGTGATATCTAGACCAATATCTGCCAGGAAAT
sequence_640	GGAAAACCCAAAGCAATGTCAGAGTTGACAAAACTGCAATGGCACTTTATATATGGCCTGTCGTGAGTGAGCTGTTTAGG
sequence_641	NTTAGAAGCTGTAGCATCATACTCACGTCAGNTTACCAGATCTTNCAGTTTTACAAACAGTAAGAGGNTTGCTCNTTAAA
sequence_642	TGCACCTGGTGCAGCAGCTAATCGAGTGGCTTTAGAAGCCTGTGTACAAGCTCGTAACGAAGGGCGCGATCTTGCTCGCG
sequence_643	GGATTATGACAGCTTCTNNCTCTCTTTTATCTCTCTCTCCATCTTATTANGCAGATATCACTGCTTGAGGTGGGGGAAGC
sequence_644	TGAAAGTCGAATTTATTCCACTCTCATTTGAGAGTGCGAATACAAGGAGGTATTTTGTGTTTGGGAAAGTCCGAAGAAAA
sequence_645	TTTTTTCTTGTCAAAAGTTCCACAAGTATTACTCCGAAACTATACACATCACTCTTTTCAGTTAGCTGCCCAGTATGGTA
sequence_646	AAAGAGATAAGTTGAACAAGTATGGTCGTCCTTTATTGGGATGTACTATTAAACCAAAATTGGGATTATCCGCAAAAAAT
sequence_647	CGCCTAGTTGGTCTTGTTGGGGCACTCGCGCGAGAAGTGGCCAGACTCGCCGCAGGAGAAGCAGCCGCCGCCACCGCCAC
sequence_648	CGAGGAGGCAGCCAGGGCATATGATGCTGAAGCCCGCAAGATCCGTGGCAAGAAAGCCAAGGTTAATTTTCCTGAGGATG
sequence_649	NGAGCGCAGGCATGTAGCGAGCAGAAGGGCATCACCAGCCCGGAGGGAGTTTGCGGGCAAGAGTAGGAACCATGGCGACA
sequence_650	GTAAAAAATGATCTCACATTTTGGGACGGAGGGAGTATGATATAGGCAAATGAGAAACTTTGCTATGCAAACTTTGCGCA
sequence_651	GCTGGGCGCACAAGCAGAGGAAAGGACGGACTTCTGACGCCGTGCTTAGCTGTCCCGCGTGTTTCACTACCTTGTGCCTG
sequence_652	GGGTATTGCCTGAAATATTTGCATTAGCAAGACTGAGCTTCCAAAGCTGAGGGACAGTGCCAAGAACCAAGGGATTTTCA
sequence_653	CTAGACTGTAGTGTAGCAAGCTGGGATGGCAGCAATCGTCCACAGCGCATACATTTTTTTCATCCTGTGGCTTCTGAGGC
sequence_654	TGCTGTCCTGTGTCAGAGTCCACCATGTATATTGTTGGACATATATTTCGTCCAAATGCATAAATAGAAAGCCCGTAAGG
sequence_655	NTGNTGNACGTGTNTTGCTCTCTCATGTATAACATGTTGTNANCACNACAGCNNNATNCATAGCTTNNACNTGTANTCNN
sequence_656	TCTTGGTGGTGGTCACTCCTCCGTATCAGAGTCCAGCGGGCAGGAGCCGTCGTCGATGGTGGCCAGCGGGTCGAACATGT
sequence_657	GGAAAACCCGCTGTCGGACCTGATTCATTGCCCTTTGTTTTTCAAAATAAAGGGNNTCATTTTTAGACTTTTCCAATTGT
sequence_658	GCATTTTGGGTTACGTTGATGAAGACCTTGTTTCCACTGACTTCCAGGGTGACAACAGGTCCAGCATCTTCGATGCCAAG
sequence_659	NNCAGCGACATNGGCCGGGAGCTCCTCAATGACCACGTTGTAGAACTTCTGGATGTCGAACAGCATCCTCTCATCTTCAC
sequence_660	GCGCCACCGACTCCANATATNCCAANCACAGGTNTCACAATATTCTTTGTGAATACAGCCCATACAAATNCCTNCTGTAA
sequence_661	GAAGACGATGACGACCCAGCAGAAGATCTTGGCCATCCAGCCGCCGTGGTGGACCTTGTCGCGCGGGTCCTTCTGGTCCT
sequence_662	GGAGATTGTGCTCGCCTCACTTCTCTACCACTTTGACTCGGAGCTCTCAAGTGGAGTTAAGCCAGATGGGCTAGACATGA
sequence_663	GAAAAATCGGCCATAAGGGGTATTCCAGCATCCTCCATCGGNACCGGAAAAGTTTGTTTCTTCAGGATTCTGCCACATGC
sequence_664	CNCCCAAACCCTCCCGCCGCCGCCGCCGCNCGCCNCNGANNAGCAGNCATGCCGCCCAAGCNNGNCCCGTCGCAGGNNNN
sequence_665	CAGGCTCAGATATGTCATCAGAGGATAGTGATGATTCACACAGAAAATCAAGCAAGAGGAATCACAAGCGCTCGAGTTCG
sequence_666	TGACAANGGTTACTTCAAGATGGAAATGGGCAAGAACATGTGTGCNGTTGCTACCTGCGCGTCCTACCCCATCGTGGCGG
sequence_667	GGGACGTCCAATCCCTCCTCGCCTTCGTGAACAGCCTCAGATGAGTGGTCAGAGAACCGGAGAACCATCGTTCTCTGCAT
sequence_668	AAATTCGGTACTAATACTAANATAGTTGTAGAAAGAGTACCTCTTTTTGCCTGGACTTCAAGCAGTTTAGCTTTAACCGT
sequence_669	CGTTCATCACGTCCAGGAACTCCTCCACGCAGAGCCGGCCGTCACGGTCGGCGTCGGCTCGCGCCAGCATGTCCCGCGCC
sequence_670	TTTAATTGCAATCAATTAGAAGAATAAAGAAGAATTACTGCATTTCATAACTGATTTTTTTCTCTTTTTATTTCGTTTCT
sequence_671	TTAATTGCAATCAATTNGAAGAATAAAGAAGAATTACTGCATTTCATAACTGATTTTTTTCTCTTTTTATTTCGTTTCTT
sequence_672	GTGGAGGTGCACTTGAGGTCCGAGTTCGAGGTGGCCCGGTCGACCAAGGCGTACCGCGCGGCGCTCCAGGCGCTGCCGCC
sequence_673	CCGGCTAATCATACCAGCCACTNGAGCACTCGNTTCGNTTCGATCTCTCTCGGCGTCTCGAGCTCCCCGTNANTCGGTCT
sequence_674	GCCGCAGCTTGTGAAGTATGGAAGGCGATCAAATTCGAGTTCGAGCCGGTAGATACTATTGATTAACTAGATAAAACTAA
sequence_675	CTGTGCCTTACCACTGTGAAGAACGAGGACAAGCTTGAGTTCAGCAAGATCTTGGAGGCTATCAAGGCTAACTTCAACGA
sequence_676	GTTTTGTGCTCGTTGTGTTAACACAACACAGCCAGGAGGTGAAGGAGTTATAGTTATGCAGATTGGAGCTTACTTGTTAG
sequence_677	AAAAATCACAACACCGATCCCGCTCCGCGGCTACACACAACCCACCATCAACCGAGCAAAAAGGACGCTAATATACACCT
sequence_678	GCTCGCTTTATTCTAAGCCAAGCAAAATAAAGCAACAAACCAAACTTACACGCCCAATATGCCAATGTGCCACGCAAGCT
sequence_679	GAGTCGTGATCTGGTTTTGCTGATTCGTAGAACGAAGAATACAAATAATACGACGTGGCGCCATTTTGCTTCTCATGGAA
sequence_680	GCGGAGTTTACACCAGTGACCATTGTGGTACTACACCTGNTGATGTGAACCACGCCGTCTTGGCGGTTGNNNATNGTGNG
sequence_681	GCGGGGCCGGAGGAGGAGGAGCGCACGGCGCCGNTGCGGCGTCGANANGGCGAGCGCCGGCGGTGANCGGGGGGCACGGG
sequence_682	CGCAAAACTGCATCAATTACCAACCCAAGAAAACTGAAAGTAGCGGGTAGATTTTTCCAACGAAGTGCAAGGGACTGTAA
sequence_683	TCTCCCCGGCGACGGAAAACTCGTCGGGCACCGGCACGCCCAGCTCCTCACACACGAACCGCACCACGCGCCGCGTGACG
sequence_684	CTTCTTACTGTCAATGTAACGNAGTATTCTTTCCNTCNNGAGCGCTAGTTTTTCCAGCGGGGTGGCAACATGGACAGAGN
sequence_685	CNTACATCTCGATCGGAAAAGAATCAATAGAAGGAGAATCGGACGATATCTTTCTCGAAACAAACAAAAAGGAAAAGAAA
sequence_686	CTCGTCTTTGAGTGGCGTGTAGCCTCTTTGTGTGAGCTGGCGCAGCCGGAGCGTGCAGACGAAGCCGACGGCGCTGGTGC
sequence_687	GATTTGCATNACNNGCANACATGNGGCCTCTTGTTCGCTGGCTCTAANATGCNGNATCTACGTAAGCNNGNCTGCTNCTT
sequence_688	AGTACAATCAGGTGCAGTGATAGGAGGAGTTGCTGGTCCTGCGACGAACTTGAACATAGGGATGGACTACTGGGGTGCAA
sequence_689	GCACAATTACGGTAGAAAATAAATAATCCAGCCAGCCATACGCAGGCAAGGATTAATAATTATGGTGGTAAATAGGTAGC
sequence_690	CAAGAAGTGAAGCCGCGTGCATCTGACAGGAGTCGAGGCTTTCGAGAGAGCTTGGCTGGGCAAGTTTACCGCTAAATAAA
sequence_691	CTACTCTCTCATCACTTGAGGAATTAGTGATTCGGCATTGTCCAGAGCTTGTGTCCGTTGGTGGNGCAGATGACATTTCA
sequence_692	GACAGTATGTACAAGGTGACAAGACTTTTTGTGATTCATACATGCTAATATGATAGAACTGCAAACCTCTTCTTACACAC
sequence_693	AAAAAAATGAAAGAAACAAACGTATTCAATAAGCAAAAGGAGAGAGAGGGATTCGAACCCTCGATAGTTCCTAGAACTAT
sequence_694	GAAACAGAGATGATCCGATGACCACAAAGATGAAGAATCCAAGCACTATAGGTCCAACAGGATAGTCATTCCCCTTCTTC
sequence_695	GCCGCATGCATTTAGCCTGGAATTTTATTTTCAGGAGTTTGTGGCTGCAATACTTGTACACTCCACAAGCTTCATGTCGA
sequence_696	TTTCACTCAGGACTGGGTATCCATGCCAGGTGTTATACCGGTAGCTTCAGGTGGTATTCATGTTTGGCATATGCCAGCTC
sequence_697	AATTACTTTGCATCGTTGATTGCATACATTCACAGGAGGTAGCTACGTAGATTACAGAGACGTGCATGCAAGCAGAGACC
sequence_698	CGGAGAGTCTGGAGCAGGNGNTGGTGNACCTGANGGGGGAGCNCTTCCTGCTCCGCCTCAAGCGCNCCGCGCGCCAGGNG
sequence_699	GGAGAGCTTCGGCGGCGGCGGCAGGACGTGCATCACGGCGCGGGTGNACCCGGACCACGTCGTGAACGGGAACAGCCACC
sequence_700	AAATTTTACATTAGCTATTTCCCGTTTAAATTCGGTACTAATACTAATATAGTTGTAGAAAGNGTACCTCTTTNTGCCTG
sequence_701	GCGGGTATAGCGGATCCTGTATCCGTGTATACAGTATACAGNGATATATCGAAAAGGAACTNGTATCTGATATCTTTCTA
sequence_702	CGGCCGGTCCGCCTCACGGCGAGCACCGACCTACTCGACCCTTCGGCCGGCATCGCGCTCCTAGCCTTAATTGGCCGGGT
sequence_703	GGCTGAGTGGTTGATAGCTCCGGTCTTGAAAACCGGTATAGTTCTAGGAACTATCGAGGGTTCGAATCCCTCTCTCTCCT
sequence_704	CGAATTTGATCGCCTTCCATACTTCACAAGCTGCGGCTAGTTCAGGACTCCATTTGCAAGCTGCTCGGATAATTTCATTA
sequence_705	CAAGTCCTAGATAGGTTCTTTGCCACCGCCATCACGATCCCAGACACTGTTCGCTTACTTGAAGCACTTGGCGTCCAGCA
sequence_706	GTAATTNTGTTGCTGATATTGTTTTGGCTNNAATNAANATGAATCANCCACANGCTTCGATNCCTAACANNTTTACTTTC
sequence_707	CGGGAGAAGCTGCAAGAGCAAAGAAAGCTCCTACATTCAGACCGAGAATCAATANCAGAACAAATTCAGCAACNTGATGT
sequence_708	GAAAGGGATGGGCAACCTGGAGAAACAGCAAAACGACAAGATCCTGAACAGTCTACTGGCCAAGAACTTCGAGGAACCGT
sequence_709	AGGAGCGGCAGCGCCATACGCCGGCTGCGCGCTTCCGTAGGCGGCAGGGTACCCGGCGGGCTGCGGTGGCGCAGCGGCGC
sequence_710	TTAAGAGGGCGCCCAACAAACTGTAGCATATGCATCGTTCACCAGGCAACGATCTTCCAGCGCTGGTTGTCGCCCTCAGT
sequence_711	GCAAAGGAGGTCACTGGTGCGAAGATTGATGAATTAGCACGTGCGATTGAGGAAGTGAAGTCAAGCTGAGCAATTCCCTG
sequence_712	CCTAGTTACGCCTATGCGAAAATTTGGTAAATGGCGGGCTGGGCTGGGACCTCCGGCCTTCGCCATGCNCAGGCCGACCG
sequence_713	TTGGTGGTACAAACATGATTCATGTCGATCAATAGAATATTTATCTTTGGATGTCGGCATTGTTCCCGCTACCCTTCACA
sequence_714	TCGCGCCACTTACGGGTCTGCTGATATTCTATAAGACGAGTTCTATACTACGGCAAAAGGCATAACTTCATACATTAAAC
sequence_715	TTANCNTTAGTTTTANNTAGTTANTNAATAGTNNCTACCNNCTCGAACNNNNNTNNNATNNCNTTNNATACTTNANAAGC
sequence_716	GGAGAATATCTTCATGCCACGTGTACATTGGTCCTTGAGTGTCAGATATAAAGGCAGAGGCCAAAAGAGCTCGACTGGGA
sequence_717	AAACAAGTGCGGTTTCACCTCGAATTTGCAATGGATAATACAACAACATTAGAGACCGTCCATGGCGGCGCCCAAGCGCA
sequence_718	GAAGGACCCCACCGGCGCCAAGGTTACCAAGGCCGCCATCAAGAAGAAATGAGTGCTCTGGTGTNTGCCATCGAGTTATC
sequence_719	AGACAGAGATGAGCAGGGACTAGGATGTAGGTTCATAAAGAATATGAAGCAACTTCGTGGACTCTTGAAGATAAGTAATG
sequence_720	CTTGAATCATAACGACTTACTTCAATTTTGACCCTATCCCCCATCAGTATTCGTATAGAACTAGACCGTATCTTTCCTGA
sequence_721	GTAAGTTAGAAGGGGAACGCGAAATGACTTTAGGTTTTGTTGATTTATTGCGCGATGATTTTATTGAAAAAGATCGTGCT
sequence_722	GTACGTCCGGTGGATGACCAAGCTCAAGGGTTTGGTCCAGTAGTGAGGTTGAACAGATGGCCTTGCCGCGTGACTCGACA
sequence_723	GCATTTCATAACTGATTTTTTTCTCTTTTTATTTCGTTTCTTTTTTATTTATACCTTCTTTATCTTTAGTTTTATCTAGT
sequence_724	TTGGTTTCTTCGGGTTTTGATTGATACANGATAGCTTTGGGAGCATGTTATGGCTACAGCACAGCTCGAGTCTTTCTAGA
sequence_725	GCCGAGTTTAATTGCAATCAATTAGAAGAATAAAGAAGAATTACTGCATTTCATAACTGATTTTTTTCTCTTTTTATTTC
sequence_726	TCATCTTCACNATACCGGCATCACCGTTCTTCAGGAACTTGGGGAGCGCCTCCAGCTCCTTACCAGATCGCCTGTCAATC
sequence_727	GCCCAATACAAAGCTGAGAAACAGGAGCTGGAGGATGCGGTGAATGCTAAAGCGGTGATGGCTGCAGTCGCAAAGAAGGC
sequence_728	GGGGTTTTCACCCAGGCCAACACTCATTGCCACCGAACGCCACACCCTGGTAACCACACCGCCCCCACGACCATAGTCAC
sequence_729	ACTAACTAGCCTTGCTGTAATCAAGGAACANCTACAAATATGTGCCTTCATCACCAGCAGCCTCCTTTGAGAGCTTGTCT
sequence_730	NCGATGGCGTCCAGGTACNTNGCGCTCCGGCCGTGGAAGCCGACCACCTTCCCCNTCNNGGTGGCGGAGGTGAAGNAGGN
sequence_731	CACTAAGGAAAGCCCAAGATGAGGTAGATCGTGTTCTACAAGGTAGACTCCCCAGATATGAAGATGTAAAAGAGCTGAAG
sequence_732	CACGGTTAAAGCTAAACTGCTTGAAGTCCAGGCAAAAAGAGGTACTCTTTCTACAACTATATTAGTATTAGTACCGAATT
sequence_733	CTCTTAACTAAGATTTTCTTATTTATACCTGTTCTACTTTTTTTCTGTTCTGGCTCGGTTATTCCATCTAGCCGNGCCAT
sequence_734	GCTTAATGTCCCAGCGTTTGTGTATGTGTATAGGACAACGAGAACATCTTAGCTCTTCTTTGTACCATAGATGTGAGAGG
sequence_735	CCTTGACAGACTTGTCGTTCTTGTCGGCGTCGGCACGCTTGCGGAGCTCGTCCATGATGGCGTTCTCAGGGTTGATCTCC
sequence_736	GTTTTCGTCATTGGTTTCTCGATCATCATTTTTGGCNACAAAATTACCACACAGACTGGAATCGGAACTTNCGTTGCAAT
sequence_737	GGCTCCACGATGTGCAACGGCGGGTGAAGGCCCAGTGCACAATGAGGAGGAACAAGTGGCGAGCCAATTTCATACAGAGG
sequence_738	TTCGTTACGAGCTTGTACACAGGCTTCTAAAGCCACTCGATTAGCTGCTGCACCAGGTGCATTTCCCCAAGGATGTCCTA
sequence_739	TGGGGAAGTGATCACCTTTTCAAAAAGAGTGATTTTCTTCTCAGCTGTCTCAATTTTGTTTGAGATCGAAGCAGGCATCG
sequence_740	CAAGGTTAGGAACCAGTACAATCCATTTTACATCAACATAACATATAAACTATTGAGGTTGTTATTCATGTTATTTCCGT
sequence_741	GCAAATGGAGTCCTGAACTAGCCGCAGCTTGTGAAGTATGGAAGGCGATCAAATTNGAGTTCGAGCCGGTAGATACTATT
sequence_742	TTAATTGCAATCAATTAGAAGAATAAAGAAGAATTACTGCATTTCATAACTGATTTTTTTCTCTTTTTATTTCGTTTCTT
sequence_743	GTTCGATTGAGAAATGTTTGTTGTGAATCCAAAAAATTGTAAGGACAGACCCAGTGCATAATATTTTCCTTTTCTTGTAG
sequence_744	TGGGATCTCATCTCGGTGTAACGCTGCAACGTTATACTATGTCCCAAGTAAACTTTGAGATAGGCTTGTCGCCAATTTTT
sequence_745	GGGAGATCATATCCACTCCGGTACAGTAGTAGGTAAGTTAGAAGGGGAACGCGAAATGACTTTAGGTTTTGTTGATTTAT
sequence_746	GTCGATGTCAAGGCCCTTGAGCTTCACCACGGATTCAACGTGGCCCTTGAGTGTGTTGAGCTCCCTCAACCTTGCAATCT
sequence_747	GCCGAGTTTAATTGCAATCAATTAGAAGAATAAAGAAGAATTACTGCATTTCATAACTGATTTTTTTCTCTTTTTATTTC
sequence_748	AGACAATAATAGCATAGACTCTTGACACGGCGATGGATTCAACCGGTCCATGAAACTGACTAGTAGCACTCTAGTTCTTG
sequence_749	GTTTGTTACAACATATGGATGATATGCACATGGAAGGCTGATATAAACATGCTATAATTGTTTGGGCTATGATTCGCAAG
sequence_750	GGCCGAGGTGATCTTCCTTGGGCAGTTCCGGCATGATCACCTATTGAAGCTACTTGGGTACTGCTGCCAGGACAAGGAGC
sequence_751	GCGCTCACGCNCCTGCCAACAACGACGGCGCCGTGGACCAGCGCTGCCGNTCGAGCTCCTCCNGGNTCGNNNNGGGAGGG
sequence_752	CGAAGTGGCAGGCAAGGGGATCCTGGGAGCTCTCGCTTCTTTCTTAGTCTTGAGGATAACATCTTCCGAATCTTCGGAGG
sequence_753	GTCGGACCCTTTATATAGTAGACAAGAATAGAAAATAATCCAGCAAGTCCATTCNGTCTCTAATANAACCACTAAACTTG
sequence_754	GGTGAGTGAGCTGTTTAGGCCTTGCCGGACTCCTCGCAGCCCGGTGGCTTGAAGGCGATGAAGCTGACGCACTGCACCTG
sequence_755	GTAAGGGCCGTCATGGATCTCCACCTCAATGGTGTAACCCCCGTTGTTTATGAGAAAGATGATGTTGTTCTGTTCCCACC
sequence_756	CCGCGAGCACGATCTTTTTCAATAAAATCANCGCGCAATAAATCAACAAAACCTAAAGTCATTTCGCGNTCCCCTTCTAA
sequence_757	CTCGAACTCGAATTTGATCGCCTTCCATACTTCACAAGCTGCGGCTAGTTCAGGACTCCATTTGCAAGCTGCTCGGATAA
sequence_758	CGGCTACGNCGGCCAGCGCGGCGGCGGCGACTCCGGCGGCCAGTGGAGGAACTGAGCGGCGGGCCCCNCCAGNNATCGAT
sequence_759	GCTACGACACCCTCAAAAAAAAAAAATTTACCTGCTACGACAGATTGTATCTACCCAACTAATCGTCAGTTTCATCCTCG
sequence_760	CGACGAATTACTTCTGAATAAATTCAGAAATCATATGGAAGAACCATAGCATTTCGCGACTCATTGGTAAATCAACTTTG
sequence_761	ATTTTGACCCTTTTGATGGGTAACGGAGTACTAGCAGNAACNTCCAGNAAGNATGNACCGNNAAGCAAGANCAACNAAAT
sequence_762	GGTCGCGCGGGTACCCAGACACCCGTCTGGTCGGGCGCGCGAGGTGCGGCGGTGGAGTGATGGCGCTGTGGTGGAGNTGG
sequence_763	GTTTTCTTTTTTTTTTTCATTTTGGATTTTAAAACATATACGTAAAACACAATCTACTAAATTAATTCTTTGGTCTCAAT
sequence_764	GAAGATTCTCCATTTGATCGTGTGTTCATTTGAGANCACTGAACCATCTTCAATCCGACGTAGACCAGTAACAANAGCAT
sequence_765	CAGAGATCAAGGAGGAGGTAGTTGACAGCTCACTTGAATTCCTTATCCTTGCTAGTGATGGGCTATGGGATGTTGTAACT
sequence_766	GCTGTATTTGCAAGAGAATTAGGGGTTCCTATTGTAATGCATGACTACTTAACTGGGGGATTCACCGCAAATACTACTTT
sequence_767	AAAAAAGAAGAATCCTAGAACAAAATGAGAAGTTGATAACCAACTTCTAGGAGAGACATAATTAACTGCATTGATCTCGG
sequence_768	CGCGAAATGACTTTAGGTTTTGTTGATTTATTGCGCGATGATTTTATTGAAAAAGATCGTGCTCGCGGTATCTTTTTCAC
sequence_769	CCGGCAAGGCCTAAACAGCTCACTCACGACAGGCCATATATAAAGTGCCATTGCAGTTTTGTCAACTCTGACATTGCTTT
sequence_770	TTTTNGCTATCTTCACGGATTATCTTTAAAATTCTACTGAGCAGTTACAACTTAGTGCAAGACCCACTGGNATCTTTGAT
sequence_771	GTTCAGTAGAGGAAAGCTTCCCCAAAGCTTTTCTCCTCCACAAGCAGAAGGATTGAAGGTGGTACCCAGGGGGGAACAAG
sequence_772	CTTCGTTGCGTTTTCTGATCAGCCTCGACCGGTCAAGCCAGCGGCAACCTCCGAGCTCTCGGTTCACTCGTCGAACACCT
sequence_773	GCTAATGTAAAATTTATCTGATATAGAACACTCATATCGATAAAATGGTTTGAACTATTTACTAGAAAAAAAAAGGGGGC
sequence_774	AAAGATTTTATCTATCAATAGTCGTAGTTTAGATTGATATATTGAAAAATGTAATATCATCCACAAGTTCTTTTTCTTTC
sequence_775	CGGATACGCAAATCATCTTCACGGAGCAGCACCGGCGGCGTCCTCCGACGACTTCTTGTACTCGGGCTTGAGCTCGTGCG
sequence_776	AGAAGAATTACTGCATTTCATAACTGATTTTTTTCTCTTTTTATTTCGTTTCTTTTTTATTTATACCTTCNTTATCTTTA
sequence_777	GTTTAATTGCAATCAATTAGAAGAATAAAGAAGAATTACAGCGTTTCATAACTGATTTTTTNCTCTTTTTATTTCGNTTC
sequence_778	GACGAGATAAACTGCTACTACAACGAGATGATCACTGGCTGACGCCAAGCCACTTGGAGAAGACATCGAACTCCGTGTAG
sequence_779	CTTGTGAGTACCAAGCTTTCTCTTGGCGACCTTGAGTGCACGCTTGTCCTTTCCAACCTTAAGAAGCTCAGTGATACGTT
sequence_780	CTATTTGTAGGAGTAAAATAAGGATTAGGCTGTGGAGNGATGGCTGAGTGGTTGATAGCTCCGGTCTTGAAAACCGGTAT
sequence_781	CTGTAGCTCATTACTGATCCCATTGTTTTTTCCAGGCTTCAGGATCTTTGTAGAGTCTTTTACGTTTGAGTTTGTTGCAC
sequence_782	CAGGAACAGCGTGGGCGCCTGGTGGTACTTGACCAGTGACTTGCCGGAGCCGAGCTCCACCAGCAGCAGCGCGGTGAGCC
sequence_783	CTGCCGAACGTGACGAAGCCGAAGCCACGGGACCTCCCCGTCTCGCGGTCGTTGATGATCTTGGCGTCGAGGATCTCGCC
sequence_784	TTGATATGATGGATGGTTCTGCAGTTGAACATCTAGTCTGCATCATCGTTGATGATGGACGCCGCATGTACTTCTCCATT
sequence_785	TTGTAGGAGTANAATAAGGATTAGGCTGTGGAGAGATGGCTGAGNGGTTGATAGCTCCGGTCTTGNAAACCGGTATAGTT
sequence_786	AGATGACAAAGTTTAGTATTGCTAACAACCAGAAAATTTGAAGAATCGCAGCAAGCTAAAAATTTGGAAACTCAGATAAT
sequence_787	TTCACAGCCGCATGGAAAATCTTAGTCTGTTATTACAACCACTCAAGGGTCGCATGAATGTCATGTTGGAAAATACAGTT
sequence_788	CGACGAATAACTTCACAGTCGAAACACTTGTGCAGCTTGGACATCTAGGTACACGCGGTGCGCTGACATGCATCAGCACT
sequence_789	GGGGGAGATCATATCCACTCCGGTACAGTAGTAGGTAAGTTAGAAGGGGAACGCGAAATGACTTTAGGTTTTGTTGATTT
sequence_790	CTTCACTGCTCGCTGATTTCTGGGCATTTTTTTCTTTTATTTCTGGTTCCTTTTTTCNTTTTCTTTTATNATTTTCCNTT
sequence_791	GGGGANCATGCCCAAATGTCAAGTCTGACCACCAATNTACAATCATATATCATTGGTTCATGATACGAGATATAACGCCA
sequence_792	GTGNCTTTNNANGCCTGTGTACAAGCTNGTAACGAAGGGCGCGATCTTNNTNGCGAANGTAANNAAANTANCNGAGCAGC
sequence_793	TTTTGTGCACGCTAATTCAGCGTTTGTATTGATTAGATACCAATGTTCAGAAACAAGATTTTTGATGGATGGGTTTATGT
sequence_794	TAAGGATTAGGCTGTGGAGAGATGGCTGAGTGGTTGATAGCTCCGGTCTTGAAAACCGGTATAGTTCTAGGAACTATCGA
sequence_795	GCCACTCTCAGTGAGAAGGCTGACATATCCATCATCAGTTATGTCAATCAGCTGATAATCTTGGCGGTCAACATGGGGGA
sequence_796	GCCGCAGCTTGTGAAGTATGGAAGGCGATCAAATTGGAGTTCGAGCCGGTAGATACTATTGATTAACTAGATAAAACTAA
sequence_797	GCAGGGGGGAAGAATACCCCCATTCGGCACCCCCGATTAAAAAAATCCCAATGTAGCAAAACAAGAGATAAAACATACAA
sequence_798	GACGGCACTTGCGGTGGAGGCAGGGCGTGGGGATGGGCTCCTCTTGCAGCTCGGCAACGGCACCGGGCAGGCGTGGTTCG
sequence_799	CACCCCTGATGGCCATGTTCNCTACAAAACGNATNTCATCTTCANNGTTGCTCACAAACTTCNTAAGTTCCNTGGACANG
sequence_800	GGAGGAACAGCGCCGTCCTCGCCAACTCCGAGGACACGGTGTGCATGCTCATGGACCGCTTCGCCCCGGCCTGATGCGCC
sequence_801	GTGAACTCCACCACGCGCACCTCCTTGCCCTTCCGGCGCAGCATGGCGGCGTACCGCCTCCCCCAGTCCTGGAGCGGGTC
sequence_802	TGCGCGCCCATGAGCTTCATCGCCGAGCAGGCCGGCGGCAAAGGCTCCGACGGCCACCAGAGGGTACTCGACATCATGCC
sequence_803	AACAATCAACAAATATGACTGTAGGAGCCACACGCAAAATCGGTGGCCCATAGGCTTCGTATTTGCTTCATGATACAAGA
sequence_804	CTTTNGGGTGGCTGGTGGCATGTCGTCATTTTGTCTGTACTTTGTCGCAACATCTCCCATATCTTCGCCTGTTGCNNCTG
sequence_805	GCGCGTACCAATTGAAGTATTTTGAGGTATCTTTTTTGAACTGAGTTGAATGAAGAAAAGAAGAATTGGAAGAAGAAAAG
sequence_806	CACGCACGCAGCATCTTTCCAATTACTGATACGAAGTACAACGATCAAGTATCAACAGAGGACGACATAGATAAGGGAGA
sequence_807	TTTAGGACATCCTTGGGGAAATGCACCTGGTGCAGCAGCTAATCGAGTGGCTTTAGAAGCCTGTGTACAAGCTCGTAACG
sequence_808	GCCANCAGGGGCTAGCGGGGTCCTTTCAAGATCCGGGCAAGCACCAGGTGTNCTGTAGCTGAAATGGCANGTTTTATNTN
sequence_809	ACGCAGGAGACGAGCNNAAGCTGCTGGGCATNTGGGNGAGCCCGTNCGNGGNNAGNNTGCNGCTCGNNCTNCNCNNCANG
sequence_810	TGGGGCGGCACATCTGTTAAAAGATAACGCAGGTGTCCTAAGATGAGCTCAACGAGAACAGAAATCTCGTGTGGAACAAA
sequence_811	GGAGTTTCTGCGCGATTTCAAGAGGAGTCACCAATTTCAATCATCACCGAAAGTTATCTTCTTCCCTGCACTAGGTGTGC
sequence_812	GAAATCTTCTGTAAAAAAGAAGAGATCTGTGANGAGACCACAAAGAAGCCAACCTGGCCGAGGAAAGCCTGGGTTCTTCT
sequence_813	TTTTTTTTTTTTTTTTTTTTTTTTTTTTTTNNNNNNNNNNNTTTNTNTNNNNTNTTTNTNTNNNTNNTNNNNNNNNNNNN
sequence_814	CACCAGGTGCATTTCCCCAAGGATGTCCTAAAGTTCCTCCACCAAATTGTAATACAGAATCGTCCCCAAAGNTTTCNGNC
sequence_815	GGCAGCTTGAGTCAAACCCCGAAAGAGTTTGGGATATGCCAAGTACGGCTTACAAATGGAGCAAAGTTTGAATCTGGAAT
sequence_816	ATATGTATNTGTATAGCCGGTGCTATAATTCTCATATGCATCCTCCTCGACCTACATTGGTAGGTGCTTACNTACATATG
sequence_817	CGGCGACGGCCAGATCAACTACGAGGAGNTCGTCAAGGTCATGATGGCCAAGTGAGGTGGCGGGACAGGGGGTCCTCCCA
sequence_818	GNTTAATTGCNATCAATTAGAAGAATAAAGAAGAATTACNNNANNTCATAACTGATNNNTTTCNNTNNNNANTNNGNNNN
sequence_819	GCGAAGTGCAAAGAAATCCTTGGGAAAATTTCTTATGGGATTCAGTCCTACTTATCAAACAACCTATATTGGGAAACTTC
sequence_820	CCGAGTTTAATTGCAATCAATTAGAAGAATAAAGAAGAATTACTGCATTTCATAACTGATTTTTTTCTCTTTTTATNTCG
sequence_821	GGATTGGACTAGTCTTTCTCGTAGCTATTCTGAATTCTCTCATTTCTTAAATTAAATTTGGTTAATATTTATTAACCCCA
sequence_822	TTTTTTTTTTTTTGTTTTTTTTTTTTTTTTTTTTTTTTTTTTTTTTTTTTTTTTTTTTTTTTTTTTTTTTTNTTTNTTTT
sequence_823	ACGGGAAGTACCCATTGAAGGCAGTGAAGGTGATGCACACTGTGGCACTTAGAACAGAATCCAGCCTATACGACCCAACT
sequence_824	ATGGCGCTCTCCTCCCCCGCGATCAAGCTCGCCGGAGCCTCCTACGCCCTCGGCGGCGGCCGCATCACCATGCGCAAGGC
sequence_825	AAGCCGAGCTGCAGAATGCGGGGNANNCCGGCCTTGTGACCATCCAGGGGANGNNCTCCATAGTTCTTGGGACTATCTTG
sequence_826	GNTTTGAAGATCCAGAAGACCAAGGAGAAGCAGCCATCAAAGTGAAATGGCCGAGGCCTTTTTTTGGAGGACAGATGGTG
sequence_827	CTGGACTTCAAGCAGTTTAGCTTTAACCGTGTTAATGGTCTCACATTCTTGGTTTATAGATAGAGAATCAAAGTTGATTT
sequence_828	AAGCTCGTAACGAAGGGCGCGATCTTGCTCGCGAAGGTAATGAAATTATCCGAGCAGCTTGCAAATGGAGNCCTGAACTA
sequence_829	CCTAATGCTATTGTGAATTTGATCAGCAACCCTGTGAACTCAACCGTCCCCATTGCTGCGGAGGNTTTCAAGAGAGCTGG
sequence_830	AGATGATGAAGATGAAGGCTGCTACGATGATGACAATGAAGGATCTGACTATGAATTTGATGAAAGTGATTTCAATCAGC
sequence_831	CGTTTCCATAAAAAAAGTAAACACAATCCATCATTGTGTAACTGCAACTACCAACACAAGGCCATAATGGATCAGATTCC
sequence_832	NAGGAGNATACATATTTATATTCCACGAAGGGGGAAAAGGCTCGGTGCAGCTAAAGGAGTACTAGTACTGTCTTGCACAT
sequence_833	TTGAAGGCATCAGCTTAATTTGAGTGTACTGACAGCCTGATATGGACCAGATCACCAGAACCCTGTGCCATTGAAACTGT
sequence_834	CAAACCCTAGCGCTCGCGCCGCCGCCGCCGCCGCCGCCGCCGCACCACCGCTCCTCAGCTCGCGGCCCGCGAGCTTGCGC
sequence_835	TGNAGAAGGACCCGGCGCACGCGAGGAAGCACCAGNTCGAGGCCGGCGTGGCGGGCGCGGCGGCCCTCGGCGCCGGCGGC
sequence_836	TGCAAATGGAGTCCTGAACTAGCCGCAGCTTGTGAAGTATGGAAGGCGATCAAATTCGAGTTCGAGCCGGTAGATACTAT
sequence_837	TATATCTTCTATGGATCCGCTTATTCTTTTTTTCAGAATTTGGATTTAATAAACTCTTTTTACAAAGGAAATCCTAAAAA
sequence_838	GCCCTATCCTTTTCCTTCTTCTCTACTCTCTCCCTTTTTGAATTCTTCTCTCTTGCAGGGAATCAACTCCCATGACACTC
sequence_839	CGGNTTGCAGGCTCTCCTGGCTCCTGCGGGACAGCANCTTAGAATCCTGCACTNTGNACTGAGCACAAAACTTCCCTGAC
sequence_840	GCGATTTGTCTGGTTAATTCCGTTAACGAACGAGACCTCAGCCTGCTAACTAGCTATGCGGAGCCATCCCTCCGCAGCTA
sequence_841	CCCAGTGCGGCGGCTGCCCTCCCGCGCCCTGCGGCGGCANGGGGGNGCCCNTGCCCGNCTGCGGCNGNGACGGCGGCGGN
sequence_842	NCNCACCCNGGGGCTGAGCATGCCGGANNCTNAGCTCCNCTCNGGCCTTTTGNATGANATAATNNANAAGGNNANNTGAG
sequence_843	GGGAACGCGAAATGACTTTAGGTTTTGTTGATTTATTGCGCGATGATTTTATTGAAAAAGATCGTGCTCGCGGTATCTTT
sequence_844	CGGAAATGCATACCATGATTTTTCTGTCTATCAATAACTGCATGCATTGCACGGTGAATGTGAAGAAGTAGGCCATTGTC
sequence_845	GCAAGATGCCACTGTCCTCCTCTGTNACCNGCNATNCTAATGCCCAGTNNCGTCNCTTTNTTTCGANTNNNGANCTGGTG
sequence_846	TTTTTTTTTTTTTTTTTTTTTTTTTTTTTTNNTNNTNNNNNNTTTTTTNTNNNTTTNNNNTNTTNNNNNNNTNTTNGGGN
sequence_847	CCTGTCCCTCGCGTCCTCCTCCTCCTTCCTCCGCGGCGACCGCGCCGCGCTCCCCGGCGGCACCACCGGGGGCGTGGGCG
sequence_848	ATACGAAGGCGCATAACGATACCACTGACCCTCAGCAATCTTAAACTTCTTAGACGAATCACCAGAACGGAAAACATCCT
sequence_849	GAGTTGCACATGCGACCCTCAAGGGGCCGAGCGTGGTAAAGGAGATCTTCATTGGACTCACCCTTGGGCTGGTTGCTGGT
sequence_850	AAATGATCTACTAGAATTGTTATTATTCCATAAAAAAACAAAGAAGATAGTATGTGACTGATCCATGCTCAATGCCTAAC
sequence_851	AACATATAAATTTTATTCTCCTGGTAAGTCACGGTAACACAAGGAGGTGCAGCATCCTTTGGTGGCACCAGTATTGCAAC
sequence_852	CAGAACTCTAGTGATGAACAACCAACAGCAGTCTTAAAATATTTCAAACATTCTTGAGGACATCTCCTTCATGTATACTC
sequence_853	TTTTTTTCTTCAAATCCAAAAAATTTCTCTTTTTTATACATAGGTCGTCGATTCGGCATTGGTTAAAAAAAGGGCAGGGT
sequence_854	AAATACTTAACGCCCAAATTAGTCAAATAGCTTTAGGTTCGCACAATGTTCAATGCTACAAATGGAACTTAAAACACCCT
sequence_855	CGCGATGATTTTATTGAAAAAGATCGTGCTCGCGGTATCTTTTTCACTCAGGACTGGGTATCCATGCCAGGTGTTATACC
sequence_856	GTAGATAAAACTTGTGATACATTCTTCATCAGCTCGGATTCAGTTCCGAACTGGCAAAGGCTTGCTAAATGGACCCAAGC
sequence_857	GGTAATACGGAAGGTCCTGTATGTACCTTGAGTTACAGTGAGTCATTACAGTTCTTAGTCAGAGTACAAAATTACAATGG
sequence_858	TGCAGTTTGTGTTCTCTCAGCAAATGGTTCAATNGCAAATGTAACACTTCGTCAAGCTGGTACATCAGGTGGAACTGTAA
sequence_859	CATAATTCGCTCATAAATACAAACGACCAACAATACCGCTTGTTTGTTGATCAGGGCACTGTTTAACTGCCGACGTCGGA
sequence_860	CTGCCGGTGGGCCATGCTGGGCGCGCTCGGCTGCGTCTTCCCGGAGCTGCTCGCCCGCAACGGCGTCAAGTTCGGCGAGG
sequence_861	CGCACCCTTGCTGACTACNACATCCAGAAGGAGTCCANCCTCCACCTGNNNCNCNGCCTCCNTNGTGNTNAGNANTTNCC
sequence_862	TTCCGGACATTGCATAGAAAAAAAACTCAGACCATCCTTAACCACGATTCAAACAGACCAGACCTTACCACTCCAAAACT
sequence_863	GTCGTTGAAGTCGTAGAAGGCCNGGGNGTCCNTGACGNTGCACTTCTTGCTGACGCGGCGGCGGANCTNGGCNNAGTCGA
sequence_864	TGATGATGCAAGTGCAGATTTCTTTTCACTCGTATATAAAGTGTGTACATATATATAGAAACAATCCACAGACTGTTGCT
sequence_865	CTGAATCATGGTGGTATAAATTACCTTGTCTGGCTTACATTTCTTTTCATTCATTAGCACTAGCATTTCCTCCATTATTT
sequence_866	GGAGTACCCTGACGCGTATGTCCGCATCATCGGATTCGACAACATGCGCCAGGTGCAGTGCGTCAGCTTCATCGCCTTCA
sequence_867	CNCACCTCCTACGTCATGCTCCGCGGGCAGCCGGCCACGGCCGCCTCCGCCGCCGCCGCGCCCAAGGAAGGCGAGCAGAT
sequence_868	GATGGATTCAATGNAAGCNAAACAGAATTTTTCATGCGCTGGTGTGATGTACCTCTGCCAATTCATAGAGCAANGTNNTG
sequence_869	TCCACCGATACAAATAAGACATTCTGCTAGATTACAATTCCTTTACCTCCAGACATGGCAATCCCGTATGAACAATGACA
sequence_870	ANCGGTTCCTCTCGTACTAGGTTGAATTACTATCGCGACACTGTCATCAGTAGGGTAAAACTAACCTGTCTCACGACGGT
sequence_871	CCTCCTTCATCGACGGCCTCATCCTGGGCTCACCGGCANGGCAGTTCAGCGTCAGCTGCGCCGCCTGGTGGGACTGTTTG
sequence_872	GAACAACTGCGAAAGCATTTGCCAAGGATGTTTTCATTAATCAAGAACGAAANTTGGGGGCTCGNAGACGATCAGATACC
sequence_873	GCATTTCCGTGTATTAGCTAAAGCATTGCGTATGTCTGGGGGAGATCATATCCACTCCGGTACAGTAGTAGGTAAGTTAG
sequence_874	GGCAAGCCAGGTCAAGGAGGGGAAAGAGGCATGGAAGGCGCCCGCAGAGGACCACGTCGTCGTGATCAACGTCGGCAAGA
sequence_875	NGCATNTCTCANCTCAAGATCTTCATGGGATCTTTGATTTTGGCATAGCTTTTCTCAAATGTACGTATCTATGATTGGCA
sequence_876	AGCAGAAGGAAAAAGGTCNCTGTACTGTACAGCCTCCCAATGGCGTCGCNCGTCGCCGTCCAGCCGGTCGCCGTGAGGNG
sequence_877	TTCCACCTTAGAGTACAAACGGAACACGAGAATTTTTACCCTACAGAGTAACCTAGATTGATCAAACAGTCCTACTATCT
sequence_878	CGGGTCACCCAATGGAAGTGCCCATAAACTTGCCGCCACCGAAGACCAGCACCAGCTCCGAAGGGCTATGGCAAGCGAAC
sequence_879	CCCGCCTTCACCGTCCGCCGCAAGCGGTTCAGTTTCCAGGGCGAGCAGTGGCTCGTGTTCGCCGGCGAGGAGACGCGGCG
sequence_880	TTTTGGATAAAGTTGAAATAAATTTCCTGGGGAAAACCTCAAGCAGCGTAATACCTTTTAATTTAACACAACAAAAGAGC
sequence_881	CGCCGCGACCCGGCCGAGGGCCGCCGCCTCCTCGTCGCCGCGAACGCCCGCGAGCTCTCCCTCGCGCTCGCCGCTGCAGC
sequence_882	CTTTTTTTTTATATGGCTATGTTCTATTTGTAGGAGTAAAATAAGGATTAGGCTGTGGAGAGATGGCTGAGTGGTTGATA
sequence_883	TTAAATAGGTAGGATGGCGCGGCTGCTTCGGTGAGCCGTGCCACGGAATCGGGTGCTCCAAGTGGGCCATTTTTGGTAAG
sequence_884	TGCTCCTGCGCAGTCTCGTTGACAGTGAGNAGNTCGNGNTGGGAGCCCTCGCGCTTGTNGANGANGANCNTGTTGCCGAC
sequence_885	ATCCGCTTCTAGTTCGACTTTCTGTAATCGAATCCGAGCTTTTTCGAGTTGCTCAATGGTCCCTCTACGCAATTCNTCTG
sequence_886	CGGGCTCGCCTTTTGTTGGAGGATTTTTCTGCATTGCCTCTAGATGAGGTGGATGGGAGCAAGGCTACGGAGATGGTGGC
sequence_887	GAAGAATCCTAGAACAAAATGAGAAGTTGATAACCAACTTCTAGGAGAGACATAATTAACTGCATTGATCTCGGTANCTA
sequence_888	CTNGCCTTACCACCCGTTGGCTGGCAGAGCACTGTTTGGCAGCCTGGGCACACCACAACGGTCTGTGAGTGGCTGAACAC
sequence_889	ATTTTACATAACAATAAATACTCAGACGCGTGAACACCCGGTGTGGGTGAAGATGGACTCTGCTCAAGACACCTTCTGAC
sequence_890	AATGAAGTTGACATGGGGTACGAGGATGAGCCTCCAGAGGCTGATATTGAGGAAGGGGTTGAAGAAGATCCTGAGAACAA
sequence_891	TTAGAGAAATGGTAATCTCCACCCGGAAGGATATGGAGGGAAAGATCGAATCGATGAGGGTTTTAGATAACAATCCCGAG
sequence_892	CGATGAACTCCTGCTCGTCCTTGACGATGGCGCTGACGATGAAGTCGAGGATGCTCTTCTCCTTCTTGGCCGGAGCCGGC
sequence_893	CTTCATCGGTGGATGCTACAACCTTCATCTGTGGATGCTACAACCATCAATTGCGGGAGCTACAAGCAGCGATGGCGAGA
sequence_894	GGATAATTTGCGATAGCGATCAGGGAGGAAGGAAGGGCTTTATTATCTATCCTTCTAATCCGCGTTAGGTTGTGTTATGT
sequence_895	CACAAGCAGAAATGGGTGTACTCGGATCCATGACTTGCTTGTAGCAGTGGACGAAATTTACACCGTAGCGTTATGAGCAC
sequence_896	CATCAACTTACNCCTCTCCTGGAATGTACCTTGTCAATCATCCTGTGAATTTGGGTCCCCAGCTAGCACTCTCGATTCTC
sequence_897	GCCCAGGCCATTCTCAAGGCAGCGCGCGCGGAGATCGCGGCGGCGCTCAACAAGATGAAGAAGGAGACGACCACGGAGCT
sequence_898	TGTGTGTGTGTGTGTGTGTGTGTGTGTGTGTGTGTGTGTGNGTGTGTGTGTGTGTGTGTGTGNGTGTGTGNGNGTGTGTG
sequence_899	ATAAATAAGAAAATCTTANTTAAGAGGGTTCATGTAAAGAACAGGTTCCAAATCACGATCGATTCCCTTTTCAAAACCTG
sequence_900	CAGAGTTNCTNAGCACTGAACCAGCACCTGACGGTGAAAATGTGAAGCTTGGAGAAGCCGAAGCTGAACAGCTGTTGCAG
sequence_901	TGTGTGNGTGTGTGTGTGTGTGTGTGTGNGTGTGTGTGTGTGTGTGTGTGNGTGTGTGNGTGTGTGTGNGTGTGTGTGTG
sequence_902	CTGCGCCGATGCGCATCGTCAGTGGCCTCCCGCGCTTGTAGCTGCTGTCGAACACCGTCCCGTCGGGGAACCTCGCCGTG
sequence_903	NCGAGNTTAATTGCAATCAATTAGAAGAATAAAGAAGAATTACTGCATTTCATAACTGATTTTTTTCTCTTTTTATTTCG
sequence_904	CANCGACCCATCCACCGGAAGGCGTCGATCNGCTGCGCGACAGACTCGTCCCATGGNGACCCGGGCTCTGCACTCGCCGA
sequence_905	GTAANATAACAAAATCTACTTTAAACGTAGGTTTTCAGAANAAGGATAGNCTAATTTTNTTGATATTNTTTTATTNTAGN
sequence_906	TAATTACTGACTAATGTCTCAGCTTAGATGGCGCCACGACCGAGAAACGGCAAACCGGAATCAAAAAGTTGGAAACATGC
sequence_907	GCCACCTCCAATAACCACATGATCAAGAGTAGGAGATATGTCAACAGCATTAACCGGTCGCTCTGTGACATATGTCTTTA
sequence_908	ACAAGATATTCCCCTTCACTATTACCGAGTCCTGCTCTGTCAGCTGCGCCAACCTCAAGTCCGCGTTCCTGCTCGACATC
sequence_909	TCGGCGTCTGGTTTGCCAAGTTCGGCCGGGAGGCGGCGCCGGCGGCAGAGGCAGAGGCCGAGGTCGTCGGCCGGCGACAC
sequence_910	ATGTTTACAAGATTGGTGGCATTGGAACTGTGCCTGTTGGCCGTGTTGAGACTGGTGTCATCAAGCCTGGTATGGTTGTT
sequence_911	CGAGCTTGTACACAGGCTTCTAAAGCCACTCGATTAGCTGCTGCACCAGGTGCATTTCCCCAAGAATGTCCTAAAGTTCC
sequence_912	AAGAGAGAAGACCCTCTCTGACCAGTTTGAGGCCAAGCGCGCCAAGAGCAAGGCAAGCAGGGAGAGGAAGATTGCCAGGA
sequence_913	NCAAGAATTAATAAAAAGTATGAAGTCGTTGATATCTGAAGGAATATCAATTTGTGCAGTATATCTATCAAGTTACGGAA
sequence_914	GATTTCTTTGGTGAGATATCTGGCATGTCTTTCAGTCCTGACACGGACACGCTCTTCGTCGGTGTCTGGGACAGGACCTA
sequence_915	TTTTTCCACCTTAGAGTACAAACGGAACACGAGAATTTTTACCCTACAGAGTAACCTAGATTGATAAACAGTCCTACTAT
sequence_916	CGCGTGTGTGGAGAGTGCGACACGTCTCTTGGTCGATCGTCAAAGAATCACCGACGAGCTCGGCCTAGGCTGCCGGTGCG
sequence_917	CTGAACTAGCCGCAGCTTGTGAAGTATGGAAGGCGNTCAAATTCGAGTTCGAGCCGGTAGATACTATTGATTAACTAGAT
sequence_918	GCCGGGGCCTCGCCTGGGCGTCCGAAACCTCGCCGCTCTCCTCTTCGCTCTGCGCGAGCGCGAACGCGCTCTCTTCCTGG
sequence_919	GGAGAAGGAAAACCCANAGCAATGTCAGAGTTGACAAAACTGCAATGGCACTTTATATATGGCCTGTCGTGAGTGAGCTG
sequence_920	CTTGTTCTTTGCGTTGGATGGGAGCTGCGGCACGCCGGCTTTGGCCTTGTCGTTCTCGCTTCGCACGTCGATGATAAGGT
sequence_921	GGGCAGTTCAGCCTGCTGTGGATCGACCAGCAGCAGCGCCTCGGCTTCAGCGTGGACGTGGTAGAGTCCGACTGGGGCTA
sequence_922	CTTTATTTATTTCATTTCGATTTTTCCCTCTTCCTCTATCCCTATCCTCTAGGTACAGCGTTTGCATCAATAGAGAACCT
sequence_923	CAAGAAGAACCCGCTGGACGCCATGGGCGCCTTCTTCTCGGCGCAGGTGAACCGCCGCAAGCTGGTCTCCACGCAGAAGC
sequence_924	ATCCCTTTCAGTGGAGGTCCTCGAAAATGTGTTGGAGATCAGTTTGCTCTTTTAGAAGCAATTGTGGCACTTGCAATTGT
sequence_925	GACTCATTATAGTACTAATTTCATTTTTACCAGATCGAAAAATTTTATGTTGAAAAGAAAAATTTATAGATCCAATGTCA
sequence_926	GGGAGCAATTGGCACGTCAGACAGGGGAAAAGGAGATGAACTGTAGCCAAGCGTACCCATCGGGTGATCATACTTGCATG
sequence_927	CGAGTTTAATTGCAATCAGTTAGAAGAATAAAGAAGAATTACTGCATTTCATAACTGATTTTTTTCTCTTTTTATTTCGT
sequence_928	CTTAATTGTCTCATCCTGATCTATTTTCATACGGTATGGTAGGCAAAAGATACTACTCGGCGTACATAAAGACCTTGATC
sequence_929	CAAAGATCTAAGAGAGAGAGAGACGCGTACCTGTATTCGTCGCTGTGCGCACGGGGCAGGACCCTGGAGGCCACCCTGCC
sequence_930	GGAGGATGCAGGACGACAGGTGGGACGTCGACGCCCGTGCCACGGCGGACGCCGAACAGACAACGAACGCTGCTGGTGGA
sequence_931	GCCAGCTCTTCAAGCGGTGGTGCCGCCCGGTCATCAGCGGTGTCGAGGCCGACGCGTCGTCCCGTGTCCCGGATAAGGAA
sequence_932	GTTTAATCATGAATCCATTGATTCTTCTCTTTAATTCAAATTTATTACTTAAACCGCTTTTTTATTTGGATATGGGGGTG
sequence_933	AAAAGTTGAAAACCTTGTTGGATTGTGCGCGTACAGTGATGCTTAATTGGGGTATGTTCAAATCAACAGTATTTTCCTGC
sequence_934	CCTCTTCAAATAGGTCTAATGGATAAGCTACATAACAGATCCATTGGTTGTCTTCCCCAGCAACAGGCTCGATGTGATAG
sequence_935	GCAGCAGCTAATCGAGTGGCTTTAGAAGCCTGTGTACAAGCTCGTAACGAAGGGCGCGATCTTGCTCGCGAAGGTAATGA
sequence_936	CTTCCTCAACAGTCCCTGATCAGCATTGNGCAGCAGGATCNGGCATCGTCCTTGTCTTCAAATATATCGAGGNGGGANAG
sequence_937	GATGAACTTGATGCGTGGAATTGATCTGAAAAAGATTGCGGGAAAGATGAATGGCGCTTCAGGAGCTGAGCTAAAGGCGG
sequence_938	TTANCNCCCCGNGGGCTCCGTCCTTGTTCAGGTGGGCGCGCGTGAAGTACCCCGTGGCGACAGTGTCGACGACGAGCGTG
sequence_939	GCTTCTTAGAGGGACTATCGCCGTTTAGGCGACGGAAGTTTGAGGCAATAACAGGTCTGTGATGCCCTTAGATGTTCTGG
sequence_940	GNTTTTCTTCTGTNAAGAGAGGNGGGTGTTCACATTTCCTCAAGTAGAGANGAAGCAGTATAAAGTTGTTTGNTGATAAT
sequence_941	GCCCAAGTTCTTCCCATCCATGCCTTATAATTTACCCATTACACCTTTCACCAAAACTTGCTACTTCTACTAGCGCCAAC
sequence_942	AGAACATCTCGGAACCTACGCGATGGAGCGAGATCTAGGGTACTCGGGAGCGAGCGATAACACTTTGGTAGACAGGTAAA
sequence_943	CGAGAAGTGGCCGCTAGGTTGAATTCAATCGGAACGTCATACATTAAGACAACTAGGTGAGATCAGGTCATGCTTCATTA
sequence_944	CAAGTGCCATCACCATCGATCTAGCCAGCAGCACCTTCTTTAGTTCTCTTCCTGCGCTAGCTCTTCTCTGCCTTGAGTAA
sequence_945	NTTNGTGCTGNTGAGGCCACACGCNGANCACNTGCGCGNCCNGNATNCGTNTNCGCGCCNGTCTAGAGCGNNGGGGGGNT
sequence_946	TATTAGGTCCATGAGGAAGCAGGCAAATACATATAATCGCAGAGGTATTACACATAAGATTTGTGAGAGGCTAACATTCA
sequence_947	TGGAGACTCATGGGAGCTTAGCTTCCATGGATTTTGCAGGATGCAGAGCTTGCCCACTCTCACAAACGCTGGCCCATGGG
sequence_948	GAGAACCTCGCCGACCACCTCTCCGACCCCGTCAACAACAACGCCTGGGCCTTCGCCACCAACTTTGTGCCCGGCAAGTA
sequence_949	TCGGAACTTGAGTCTGATTCTATTTTTCTATTCGAGCCCTTTTTCCTATTCTTTTGTATATAGTTCTTGATACAATCCCT
sequence_950	CGGGCGGCGNCAGCAGCAGGAACTGTCATGACGCTGTCATCGTGGGCTACCTCGAGCGTGGAGGAGGTGGCCTCGACTGG
sequence_951	GGAAACTTCCCTTTTGTTGCTGCACACACATACATATGTTGATGAACTTATGAAGGAAGCTAATATCAAGTTCCTCGGAG
sequence_952	GGCATATGCCAGCTCTGACCGAAATCTTTGGGGACGATTCTGTATTACAATTTGGTGGAGGAACTTTAGGACATCCTTGG
sequence_953	TCGCCTCGCAGTCGCCGCCGCCGCCGCCGCTGCCAGCAGCCATGGGTCGCACCAAGGAGGAGCTCCTCGCGCGCCTCGAG
sequence_954	AAAAAAGANAGATAAGGGACAGAAAAAAAAAAAAAAAATGAAAGAAACAAACGTATTCAATAAGCAAAAGGAGAGAGAGG
sequence_955	TTTCAATTTCATTAAGAAAAACTAACTAAATAAATGGAAAATGAAAATTAATAGAATTCTTTTTTATTTTTTTTTTTTCT
sequence_956	TTAACTCTTTCATGCTTACTTTAACTAGTTATTTTGGTTTTCTACTGGCTGCTTTAACTATAACCCTAGCTCTATTTATT
sequence_957	TGGAACCGCCATCCTCCTTGTGCTGGGCCTGTTTCTTCTTCTTCTCAGTCTCTTCAGTGGCAAGCATAACCATTTCAGCA
sequence_958	GTNCAGGGCATNATTAAATGTTTTGACTGAATCTGGGCCAATGTCCAGTCCCATCCAACCATCNGGAATTGCAGNTNCAG
sequence_959	CNAACACGGNATAACTCCACTAGAACNTTAAAACCTCTCTNGNAGACGGACAACCGAAACCATATNTTTGGTAGCACTTT
sequence_960	TGGTCTACATAAATTTGCAACCATTCATNATGCTAGTAAGCAGTCAGACTCCTNCAGTTCANATAATGGCAGCNCATCAG
sequence_961	AACGTCTTCTGGAAATGGTGAAGCTGATCGATTCGCCAGGCAATATGGCGAGTGCTGATGCATGTCAGCGCACCGCGTGT
sequence_962	CTAAGATCCAGGACAAGGAGGGCATCCCTCCGGACCAGCAGCGTCTCATCTTTGCCGGCAAGCAGCTCGAGGATGGCCGC
sequence_963	CTTTTTATGAAAGAAAGATAAGGGACAGAAAAAAGAAAGATAAGGGACAGAAAAAAAAAAAAAAATGAAAGAAACAAACG
sequence_964	TGGATTTCGGTCCCACATAGACANTGGAGGATGCCTTATTACTTAGCCGCGTGATGTTATTAAGGAAATACCTTACAAGA
sequence_965	ATACATCATGAATTAAGAGAAAAAAATACAAGTATGTGACAATTAGAATGAAGTAAAATAAAATATGGACTTCCAAGAAA
sequence_966	CTAATGGCCCCCCTTTTATTTCTCTTCTAGGCAGAACTAGAAAGATGAACATGGCAAGCAAACCTACGCTCTGCCCAAGC
sequence_967	GGGAACTGCTTGAACAGAGAACGGGGTGGAATTGCCGAAGACACAACAAACATATACAGTACTATTCTTTGAAAGGCCTC
sequence_968	NGAATGTNATTCCTTCAATGTCAAACCCAGCCATCTTGTGTGATTNCTTGACTACATCATACGACATTGGCGGNGTTATC
sequence_969	TNTGCAAACAACTNGTCACAGGNAANTTTCACCCGTTTATNCNGGGANGCATNCNNNNCATCAACCNCNNTNGCCTCNTT
sequence_970	CGGCAAGGCCTAAACAGCTCACTCACCACGGGCCACATATAAAGTGCCATTGCAGTTTTGTCAACTCTGACATTGCTTTG
sequence_971	GCCACACCCCCTGCTCCGTGCTATATAGAAGATTCGGTAAATCAGAATAATTAGAATGGCAAGACCATTCAACCTTAGAT
sequence_972	TGAGCTTGTCAGTGGTGAAGTCCATGCCCCAGAAGTTTGTGAGGACATTCATCCCTTGCACATCCTCAGCACGGAGTCTG
sequence_973	ATTGAGGACCGCCCCGATAGCGAGGAGAGTAAGAGCGTGAACGGGAACGAGACCTCCCATAACGGGAATGGCGCCTTTCA
sequence_974	TCCACCTTAGAGTACAAACGGAACACGAGAATTTTTACCCTACAGAGTAACCTAGATTGATCAAACAGTCCTACTATCTA
sequence_975	GAGGAACTCCTGGCCTAAGGTGCGTGGTGTGGCCATGAACCCTGTGGAGCATCCCCACGGAGGAGGTAACCACCAGCATA
sequence_976	TTCGAACCCTCGATAGTTCCTAGAACTATACCGGTTTTCAAGNCCGGAGCTATCAACCACTCAGCCATCTCTCCACAGCC
sequence_977	GAAGAAGCTCAACTCGTCGCTCAAGAAGTACGCGCCCGACTCGGCGCCCGCGCTCGCCATCCAGGCCACCATCGAGAAGA
sequence_978	AANATCAACNACACCAGAAGCANCATNAGTGACGACATTAGAAATNTCNTTTGCAGTAGCGCCAANATGNNNANNGCCAT
sequence_979	CGGCGGGGGCGGCAGCGCGGCCCTGGCCAGCGAGGCCGACGAGGACGCCGAGTGCCTGTCACTGGCCGTTTCTCTGGCTA
sequence_980	TACTTTGTCGCTTCATGAATTATTTTGGTGCACTTTTTTCTCGTGGAATCTCATTGTATAGACTGGGGAAGGAACTCAAG
sequence_981	CCGGTAGATACTATTGATTAACTAGATAAAACTAAAGATAAAGAAGGTATAAATAAAAAAGAAACGAAATAAAAAGAGAA
sequence_982	AGCACGTCGACCATTCCAGGAAGTCGGCGGAGCAGGCCGTGAAGGCAATCAAGGGGAAAGAGGCGGGGTCTGCCGTGGAG
sequence_983	GTTGCGGCCGTCCAGGTCCTGNCCNNTCATGGCCTCNATCGNCTGGCGCATCGCCTCGTCCGACNCGAAGGNGACGAACC
sequence_984	GTACAGCCATGGCCCCCACCGTGATGGCCTCGTCGGCCACCTCCGTCGCTCCTTTCCAGGGGCTCAAGTCCACCGCCGGC
sequence_985	CAGTGGGGCTGTTCACTCCCCAGCCCTCGTCCGTGAGAAGGCTGGTCGATTCAAGCTCGGTAAGGCGCAGCACAAGGAAG
sequence_986	TCCTATTGTAATGCATGACTACTTAACTGGGGGATTCACCGCAAATACTACTTTGGCTCATTATTGCCGCGACAATGGCC
sequence_987	AAAAAAAAAAAAAAAAAAAAAAAAAAAAAAAAAAAAAAAAAAAAAAAAAAAAAAAAAAAAAAAAAAAAAAAAAAAAAAAA
sequence_988	TTTAGAAGCCTGTGTACAAGCTCGTAACGAAGGGCGCGATCTTGCTCGCGAAGGTAATGAAATTATCCGAGCAGCTTGCA
sequence_989	TCCAGATATTTCGCCANTCAATACACTCNTTGGTNTCTTGTGTCAAAAAGGGNNGNNNCTNANGGNNANNGAAGTATTTA
sequence_990	GTTACATACATACATAAACCATCTGTTGGAATCAATTACTTTGCATCGTTGATGACATACATTCACAGGAGGTAGCTACG
sequence_991	CGNCGAGGAGATCGTGATGGTGGCGCCCAACATCCTGTCCATCGAGCACACGCTGGAGCGCATGGAGCTGATCCACGCCT
sequence_992	AAGAGCAGGTGCCTCTACACTTGATTCTACAGCTAAAGAAGCAAAAGATCTGATTGCTGAATCCAATGGCTGGTATCCAG
sequence_993	CACTCCGGTACAGTAGTAGGTAAGTTAGAAGGGGAACGCGAAATGACTTTAGGTTTTGTTGATTTATTGCGCGATGATTT
sequence_994	CTACACTGGTGGAACTAGAAAATTATGCTCTTGATCAATGGGAGTGCTTCTTGCTGCAATTGATCAACTCGTCTCAAGTT
sequence_995	NAGAAGCCTGTGTACAAGCTCGTAACGAAGGGCGCGATCTTGCTCGCGAAGGTAATGAAATTATCCGAGCAGCTTGCAAA
sequence_996	AATGAATAGAGCGTAAATTCTGAAACTTTGGTATTTCTTTTTCTTTCGGACAAAATAATTCCCGTAGCGAGAATGGGATT
sequence_997	CTTTCATCTAACATTGTGGCCTTATCGATTTACAAAATCTGATATGCCTGACTGGATATCAAATTCCAAATGTCCTTGAT
sequence_998	GGANAGGTCCTGCCACCCGTTCACCTGCNNCTTCATCTNCCCGGTGATGGTNCCTTTGTTCTTCGCCGCCCTCGGGTNCA
sequence_999	NCGGAGCAGTCACTTATCAGAAATTCATGCATGCCCATGGCGAGAGCAGGGGCGGAGAAACCTTCACCTTGAGTTTCAGC
sequence_1000	TTGCAAACCAATATCTTCTTCTCATGGATGTGCCGGAGTGGCACTGGCAGCTTTGGTAGGGTCAGGGCAAATGATCGGCG
